"id","owner","name","nr_contributors","commits_last_month","pull_reqs_last_month","changes_last_month","age_in_days","language","commits_all","pull_reqs_all","total_changes"
63,"pculture","unisubs",15,298,41,339,930,"Python",7540,330,7870
127,"mozilla","addon-sdk",17,89,87,176,1345,"Python",2617,1420,4037
190,"Netflix","SimianArmy",47,7,8,15,608,"Java",174,95,269
310,"intridea","grape",14,22,22,44,1312,"Ruby",462,306,768
312,"Katello","katello",36,344,224,568,693,"Ruby",15523,3462,18985
340,"netty","netty",16,605,70,675,1213,"Java",7717,742,8459
418,"sunpy","sunpy",15,101,104,205,943,"Python",1312,549,1861
474,"mozilla","mozbase",17,40,3,43,891,"Python",517,56,573
489,"Shopify","active_merchant",273,123,73,196,2116,"Ruby",1270,840,2110
587,"heroku","heroku-buildpack-ruby",44,231,30,261,1017,"Ruby",1113,143,1256
608,"errbit","errbit",10,19,26,45,1310,"Ruby",567,398,965
613,"MovingBlocks","Terasology",64,315,129,444,1098,"Java",1396,414,1810
657,"spree","spree_reviews",33,64,13,77,757,"Ruby",228,74,302
687,"gwu-libraries","launchpad",10,106,41,147,654,"Python",777,109,886
714,"puppetlabs","puppet-docs",150,202,22,224,1269,"Ruby",1757,288,2045
750,"ros","rosdistro",18,598,563,1161,785,"Python",4261,3222,7483
772,"mozilla","socorro",18,140,160,300,925,"Python",2277,1927,4204
774,"mozilla","Socorro-Tests",40,7,10,17,1035,"Python",247,237,484
807,"openmicroscopy","bioformats",47,106,127,233,884,"Java",9483,961,10444
847,"puppetlabs","puppet",195,292,189,481,1269,"Ruby",10015,2407,12422
853,"rapid7","metasploit-framework",65,213,231,444,919,"Ruby",16117,2982,19099
860,"mozilla","bedrock",18,290,193,483,1057,"Python",3616,1720,5336
937,"grails","grails-core",11,380,26,406,1485,"Java",8274,460,8734
961,"ipython","ipython",14,293,250,543,1396,"Python",8371,2591,10962
1008,"zendframework","zf2-documentation",12,158,33,191,605,"Python",2042,1113,3155
1113,"travis-ci","travis-core",39,149,32,181,850,"Ruby",2541,291,2832
1142,"saltstack","salt",15,1350,865,2215,1110,"Python",14277,6545,20822
1282,"Pylons","pyramid",19,48,20,68,1229,"Python",3550,765,4315
1299,"ooici","coi-services",43,243,221,464,860,"Python",6896,1868,8764
1301,"heroku","heroku",32,67,18,85,1814,"Ruby",2423,308,2731
1334,"rails","rails",37,697,398,1095,2155,"Ruby",35027,8997,44024
1523,"mozilla","marketplace-tests",40,29,30,59,748,"Python",567,395,962
1528,"spree","spree-guides",51,150,3,153,1295,"Ruby",1621,123,1744
1678,"cucumber","cucumber",33,57,18,75,2149,"Ruby",1611,289,1900
1799,"Theano","Theano",10,58,54,112,939,"Python",10297,1397,11694
1957,"Bukkit","CraftBukkit",14,15,34,49,1158,"Java",2133,1327,3460
1958,"infinispan","infinispan",29,94,93,187,1218,"Java",6567,2414,8981
1965,"cakephp","docs",30,318,115,433,1079,"Python",2318,1091,3409
2093,"fog","fog",53,155,127,282,1753,"Ruby",5014,1901,6915
2244,"thoughtbot","factory_girl",81,17,10,27,2102,"Ruby",293,181,474
2247,"newrelic","rpm",13,91,5,96,1952,"Ruby",4025,146,4171
2281,"gradle","gradle",15,668,19,687,1639,"Java",9161,253,9414
2309,"BroadleafCommerce","DemoSite",14,68,4,72,695,"Java",907,21,928
2532,"OpenMRS","openmrs-module-htmlformentry",23,10,6,16,857,"Java",243,57,300
2713,"openshift","rhc",12,34,22,56,961,"Ruby",758,543,1301
2719,"mperham","sidekiq",13,108,38,146,780,"Ruby",1028,500,1528
2812,"diaspora","diaspora",28,142,63,205,1268,"Ruby",11203,1668,12871
2863,"ooici","ion-definitions",44,69,50,119,863,"Java",1614,511,2125
2888,"fluent","fluentd",11,50,17,67,991,"Ruby",511,162,673
2980,"technicalpickles","homesick",14,8,8,16,1463,"Ruby",95,49,144
3329,"opscode-cookbooks","windows",29,10,2,12,722,"Ruby",130,73,203
3450,"pentaho","big-data-plugin",52,19,21,40,643,"Java",483,204,687
3465,"Netflix","servo",104,22,11,33,811,"Java",221,168,389
3479,"github","github-services",33,37,30,67,1392,"Ruby",874,591,1465
3594,"droolsjbpm","jbpm",55,115,8,123,1261,"Java",1599,193,1792
3671,"NoamB","sorcery",12,5,10,15,1132,"Ruby",154,187,341
3680,"ceylon","ceylon-lang.org",16,44,4,48,960,"Ruby",1093,78,1171
3721,"ceylon","ceylon-spec",16,64,2,66,1137,"Java",2162,62,2224
3732,"ceylon","ceylon-ide-eclipse",15,460,0,460,945,"Java",3221,34,3255
3918,"Yelp","mrjob",13,15,15,30,1240,"Python",997,388,1385
3923,"mongodb","docs",18,586,119,705,895,"Python",5158,1628,6786
3932,"opscode-cookbooks","mysql",34,17,21,38,722,"Ruby",263,170,433
3944,"Kozea","WeasyPrint",15,12,3,15,940,"Python",494,31,525
4023,"allegro","ralph",10,37,40,77,658,"Python",3538,725,4263
4068,"jruby","jruby",22,595,56,651,1796,"Ruby",12885,609,13494
4095,"elasticsearch","elasticsearch",10,1348,275,1623,1487,"Java",8985,1221,10206
4114,"CocoaPods","CocoaPods",48,44,18,62,935,"Ruby",1940,271,2211
4179,"meltmedia","cadmium",40,15,1,16,680,"Java",716,71,787
4563,"voldemort","voldemort",18,37,6,43,1740,"Java",463,87,550
4573,"infochimps-labs","ironfan",16,17,6,23,1392,"Ruby",579,105,684
4660,"twitter","twitter-cldr-rb",226,42,0,42,740,"Ruby",474,80,554
4751,"Catrobat","Catroid",166,466,29,495,646,"Java",14499,502,15001
4765,"bigbluebutton","bigbluebutton",15,102,11,113,1381,"Java",5024,308,5332
4779,"sunlightlabs","openstates",12,315,6,321,1834,"Python",8141,112,8253
4798,"opscode-cookbooks","apache2",29,16,8,24,722,"Ruby",149,118,267
4927,"collectionspace","application",12,7,4,11,771,"Java",1002,125,1127
5016,"rails","activeresource",28,9,4,13,723,"Ruby",54,75,129
5125,"rcbops-cookbooks","glance",21,8,9,17,702,"Python",258,183,441
5184,"toastdriven","django-haystack",13,10,24,34,1862,"Python",429,297,726
5210,"square","okhttp",19,421,155,576,591,"Java",1131,427,1558
5245,"sferik","twitter",11,172,9,181,2212,"Ruby",1396,170,1566
5378,"Bukkit","Bukkit",15,13,43,56,1159,"Java",588,1024,1612
5400,"ooici","pyon",44,68,41,109,939,"Python",1863,477,2340
5465,"isenseDev","iSENSE-Hardware",11,61,53,114,811,"Java",1159,825,1984
5516,"geoserver","geoserver",30,176,94,270,847,"Java",2543,527,3070
5520,"CocoaPods","Specs",440,2354,2087,4441,907,"Ruby",14220,8498,22718
5556,"Sage-Bionetworks","SynapseWebClient",16,94,88,182,664,"Java",2779,850,3629
5591,"puppetlabs","facter",195,143,59,202,1269,"Ruby",1073,649,1722
5626,"sampsyo","beets",19,205,31,236,1305,"Python",2129,234,2363
5640,"arduino","Arduino",11,107,35,142,1266,"Java",1924,316,2240
6026,"gitlabhq","gitlabhq",17,720,170,890,886,"Ruby",5856,2087,7943
6413,"twitter","commons",338,259,29,288,1101,"Java",497,177,674
6468,"ModeShape","modeshape",13,21,43,64,1149,"Java",3251,1068,4319
6570,"puppetlabs","hiera",178,25,11,36,1006,"Ruby",243,171,414
6584,"Shopify","liquid",271,73,12,85,2128,"Ruby",445,157,602
6606,"toastdriven","django-tastypie",14,9,13,22,1438,"Python",555,561,1116
6923,"rightscale","rightscale_cookbooks",151,42,3,45,679,"Ruby",1655,152,1807
6966,"CeON","CoAnSys",12,26,22,48,594,"Java",1096,243,1339
6994,"cucumber","gherkin",33,16,8,24,1647,"Ruby",1370,114,1484
7058,"pry","pry",14,215,23,238,1185,"Ruby",1384,245,1629
7233,"sunspot","sunspot",14,7,12,19,1970,"Ruby",881,270,1151
7347,"MarkUsProject","Markus",89,22,27,49,1257,"Ruby",1346,721,2067
7511,"Sage-Bionetworks","Synapse-Repository-Services",16,161,148,309,653,"Java",3076,1111,4187
7537,"kivy","kivy",11,277,93,370,1219,"Python",3637,814,4451
7588,"OpenMDAO","OpenMDAO-Framework",15,103,98,201,983,"Python",5653,976,6629
7608,"reddit","reddit",15,222,22,244,2087,"Python",2817,460,3277
7698,"datamapper","do",11,9,2,11,1865,"Ruby",240,28,268
7894,"RubyMoney","money",65,20,11,31,1952,"Ruby",576,182,758
8127,"matplotlib","matplotlib",20,86,99,185,1111,"Python",8291,1687,9978
8131,"jclouds","jclouds",24,132,38,170,1500,"Java",7905,1431,9336
8381,"nuxeo","nuxeo-core",22,101,0,101,812,"Java",1151,7,1158
8612,"jboss-switchyard","components",11,14,17,31,1184,"Java",419,650,1069
8703,"codeforamerica","brigade",104,32,4,36,762,"Ruby",795,191,986
9095,"holderdeord","hdo-site",24,136,3,139,698,"Ruby",2205,98,2303
9126,"racker","rackspace-monitoring",136,11,5,16,853,"Python",160,36,196
9241,"tangentlabs","django-oscar",57,307,67,374,1184,"Python",3399,751,4150
9354,"freenet","fred-staging",14,20,7,27,1776,"Java",16946,200,17146
9427,"spree","spree",12,508,121,629,2187,"Ruby",13807,2384,16191
9615,"forge","core",11,418,37,455,1046,"Java",3605,398,4003
9774,"podio","podio-rb",12,13,1,14,1218,"Ruby",516,7,523
9793,"sympy","sympy",21,137,164,301,1406,"Python",13428,2789,16217
9807,"exoplatform","social",17,18,21,39,701,"Java",2857,283,3140
9840,"mongodb","mongo-java-driver",12,168,10,178,1876,"Java",1733,172,1905
10083,"exoplatform","platform",16,24,25,49,700,"Java",8898,458,9356
10182,"exoplatform","exogtn",15,8,4,12,1182,"Java",1487,141,1628
10252,"dimagi","commcare-hq",20,3272,507,3779,1701,"Python",18658,2712,21370
10269,"eucalyptus","eucalyptus",13,264,2,266,1017,"Java",12528,44,12572
10384,"exoplatform","ecms",17,40,43,83,700,"Java",4846,614,5460
10412,"intridea","omniauth",14,20,2,22,1437,"Ruby",280,285,565
10646,"opscode-cookbooks","chef-client",31,35,12,47,722,"Ruby",241,153,394
10667,"hasgeek","flask-lastuser",10,13,0,13,1021,"Python",93,5,98
10882,"pivotal","projectmonitor",19,33,2,35,689,"Ruby",810,29,839
11108,"Sage-Bionetworks","Synapse-Stack-Builder",13,6,7,13,597,"Java",123,83,206
11124,"mbleigh","acts-as-taggable-on",13,9,15,24,2176,"Ruby",144,152,296
11321,"travis-ci","travis-ci.github.com",47,11,10,21,992,"Ruby",1158,387,1545
11379,"alphagov","smart-answers",118,298,85,383,862,"Ruby",4747,747,5494
11602,"travis-ci","travis-cookbooks",21,43,11,54,1003,"Ruby",1235,138,1373
11638,"rtfd","readthedocs.org",11,243,46,289,1298,"Python",2755,250,3005
11644,"opscode-cookbooks","rabbitmq",26,19,10,29,722,"Ruby",138,106,244
11959,"rails","strong_parameters",25,7,4,11,723,"Ruby",92,113,205
12031,"rubinius","rubinius",108,161,28,189,2245,"Ruby",10355,1000,11355
12106,"rcbops","chef-cookbooks",39,92,49,141,860,"Ruby",5137,447,5584
12132,"svenfuchs","rails-i18n",10,20,21,41,2044,"Ruby",246,328,574
12258,"plataformatec","devise",27,31,40,71,1632,"Ruby",1958,604,2562
12333,"droolsjbpm","drools",39,253,17,270,1112,"Java",9341,318,9659
12392,"collective","collective.developermanual",409,53,16,69,972,"Python",2305,174,2479
12455,"k9mail","k-9",19,49,17,66,1126,"Java",3679,457,4136
12747,"gregbell","active_admin",10,87,49,136,1421,"Ruby",1466,1004,2470
12841,"naparuba","shinken",23,145,31,176,1199,"Python",4156,412,4568
12885,"sferik","rails_admin",12,40,12,52,1313,"Ruby",1915,599,2514
13001,"osmandapp","Osmand",10,109,12,121,1146,"Java",6890,542,7432
13021,"thoughtbot","suspenders",80,101,31,132,1392,"Ruby",593,167,760
13116,"dmwm","WMCore",24,55,53,108,906,"Python",8725,627,9352
13573,"bndtools","bnd",10,211,12,223,1424,"Java",1963,113,2076
13718,"caelum","vraptor",21,21,11,32,1813,"Java",3503,168,3671
13860,"ruby","ruby",21,661,58,719,1468,"Ruby",32793,554,33347
13915,"kevinweil","elephant-bird",10,5,6,11,1442,"Java",418,280,698
14398,"droolsjbpm","guvnor",53,70,2,72,1119,"Java",5482,110,5592
14642,"DIRACGrid","DIRAC",24,137,64,201,1065,"Python",13927,1279,15206
14901,"autotest","autotest",25,31,13,44,899,"Python",8299,499,8798
14915,"travis-ci","travis-ci",41,11,2,13,1102,"Ruby",3732,209,3941
15664,"caktus","django-timepiece",10,20,1,21,885,"Python",2462,302,2764
15806,"weld","core",21,102,42,144,1309,"Java",4470,489,4959
15841,"plataformatec","simple_form",27,6,6,12,1529,"Ruby",558,320,878
15985,"gem","oq-engine",30,311,33,344,1347,"Python",5334,1244,6578
16166,"guard","guard",12,39,16,55,1312,"Ruby",657,214,871
16282,"tablexi","nucore-open",27,149,19,168,1098,"Ruby",1424,102,1526
16401,"nuxeo","nuxeo-webengine",22,11,0,11,812,"Java",115,2,117
16640,"mozilla-services","mozservices",11,20,1,21,869,"Python",198,22,220
16719,"BaseXdb","basex",14,130,18,148,1114,"Java",4081,332,4413
16948,"BroadleafCommerce","BroadleafCommerce",12,458,3,461,818,"Java",3999,84,4083
16968,"crowdint","rails3-jquery-autocomplete",33,6,4,10,1329,"Ruby",109,91,200
17032,"Silverpeas","Silverpeas-Core",11,121,34,155,1130,"Java",3318,480,3798
17042,"Silverpeas","Silverpeas-Components",11,42,16,58,1130,"Java",1680,290,1970
17196,"basho","riak-python-client",15,22,5,27,1420,"Python",511,203,714
17307,"aptana","studio3-rcp",18,19,0,19,1603,"Java",234,3,237
17345,"jboss-switchyard","tools",11,13,10,23,921,"Java",233,370,603
17473,"plone","Products.CMFPlone",234,151,10,161,893,"Python",1708,93,1801
17589,"thoughtbot","shoulda-matchers",84,209,28,237,1177,"Ruby",881,257,1138
17635,"isenseDev","rSENSE",10,116,124,240,582,"Ruby",981,907,1888
17735,"fatfreecrm","fat_free_crm",11,74,7,81,1927,"Ruby",3299,143,3442
17919,"spree","spree_i18n",34,62,29,91,1278,"Ruby",527,288,815
18159,"jenkinsci","warnings-plugin",301,20,2,22,1178,"Java",366,34,400
18170,"shoes","shoes4",19,99,13,112,651,"Ruby",1127,194,1321
18217,"mozilla","zamboni",30,514,233,747,1595,"Python",10106,1802,11908
18260,"adhearsion","adhearsion",10,69,12,81,1409,"Ruby",1974,151,2125
18716,"rubygems","rubygems",13,137,28,165,1420,"Ruby",5255,328,5583
19117,"pypa","virtualenv",12,46,15,61,1096,"Python",367,223,590
19428,"mne-tools","mne-python",19,96,70,166,1133,"Python",2359,796,3155
19443,"puppetlabs","marionette-collective",170,39,29,68,1232,"Ruby",890,169,1059
19844,"alphagov","publisher",113,81,19,100,976,"Ruby",2547,166,2713
19849,"nasa","mct",12,8,7,15,674,"Java",401,84,485
20225,"ging","social_stream",10,21,0,21,1259,"Ruby",1405,36,1441
20429,"thoughtbot","paperclip",83,97,28,125,2156,"Ruby",724,436,1160
20500,"mozilla","mcom-tests",40,8,8,16,1057,"Python",346,240,586
20768,"customink","fauxhai",20,18,19,37,606,"Ruby",99,61,160
20786,"cloudfoundry","bosh",112,473,30,503,703,"Ruby",6988,363,7351
20796,"hazelcast","hazelcast",15,443,282,725,715,"Java",5419,946,6365
20849,"projectblacklight","blacklight",12,338,93,431,1588,"Ruby",2115,222,2337
21093,"jruby","activerecord-jdbc-adapter",28,34,6,40,2172,"Ruby",1748,236,1984
21276,"prawnpdf","prawn",17,140,22,162,2162,"Ruby",1949,170,2119
21435,"ops4j","org.ops4j.pax.web",64,32,4,36,1266,"Java",819,19,838
21597,"geotools","geotools",27,139,47,186,847,"Java",2876,385,3261
21703,"rightscale","right_link",124,267,48,315,1693,"Ruby",2965,335,3300
21750,"nipy","dipy",20,16,17,33,1489,"Python",911,268,1179
22138,"stapler","stapler",11,11,1,12,1072,"Java",474,23,497
22616,"square","retrofit",15,91,29,120,1277,"Java",584,264,848
22668,"Netflix","Priam",103,13,4,17,960,"Java",553,204,757
22811,"opscode","ohai",76,95,32,127,1876,"Ruby",1467,285,1752
22841,"tomchristie","django-rest-framework",11,86,78,164,1100,"Python",1945,844,2789
22964,"typesafehub","config",21,25,4,29,821,"Java",227,30,257
23043,"Netflix","astyanax",105,19,16,35,967,"Java",360,181,541
23052,"buildbot","buildbot",12,73,45,118,1339,"Python",2508,1084,3592
23280,"opscode-cookbooks","nginx",31,28,10,38,722,"Ruby",227,196,423
23440,"Zipwhip","zipwhip-api",11,21,0,21,929,"Java",384,1,385
23593,"radiant","radiant",16,47,0,47,2085,"Ruby",433,60,493
23623,"opscode","knife-ec2",75,20,27,47,1095,"Ruby",228,188,416
23710,"rcbops-cookbooks","nova",21,16,21,37,702,"Ruby",360,358,718
23903,"convio","watirmark",10,12,0,12,717,"Ruby",600,3,603
24397,"github","linguist",37,38,57,95,1032,"Ruby",867,688,1555
24423,"puppetlabs","puppetlabs-stdlib",171,12,15,27,1017,"Ruby",328,226,554
24440,"mozilla-services","server-syncstorage",11,54,2,56,764,"Python",374,6,380
24575,"collectionspace","services",12,18,9,27,749,"Java",1881,143,2024
24741,"threerings","playn",15,34,2,36,930,"Java",790,17,807
24828,"jboss-switchyard","quickstarts",11,8,10,18,1106,"Java",151,309,460
25097,"plone","plone.app.theming",235,9,3,12,893,"Python",295,21,316
25156,"alphagov","govuk_content_models",91,142,24,166,661,"Ruby",894,131,1025
25326,"okfn","ckan",18,122,31,153,847,"Python",12193,932,13125
25467,"CloudifySource","cloudify",14,308,0,308,770,"Java",6119,94,6213
25822,"nltk","nltk",11,50,36,86,1641,"Python",8361,264,8625
26287,"collective","collective.facets",256,24,0,24,582,"Python",37,1,38
26423,"CONNECT-Solution","CONNECT",29,50,47,97,750,"Java",6632,687,7319
26591,"hibernate","hibernate-orm",18,284,54,338,1249,"Java",4312,705,5017
26697,"mcMMO-Dev","mcMMO",11,358,6,364,791,"Java",4894,217,5111
27142,"pypa","pip",11,105,86,191,1096,"Python",1596,617,2213
27329,"pydata","pandas",11,435,295,730,1290,"Python",7617,2133,9750
27693,"thoughtbot","bourbon",82,11,11,22,1048,"Ruby",433,161,594
27716,"exoplatform","jcr",14,15,4,19,700,"Java",3015,158,3173
27859,"thoughtbot","capybara-webkit",82,5,7,12,1105,"Ruby",251,223,474
27868,"exoplatform","jcr-services",10,11,0,11,701,"Java",260,3,263
27986,"mozilla","django-browserid",32,3,11,14,961,"Python",99,136,235
28021,"exoplatform","wiki",10,17,21,38,681,"Java",232,107,339
28030,"exoplatform","forum",11,14,12,26,667,"Java",240,74,314
28175,"enthought","chaco",83,58,7,65,1133,"Python",1209,128,1337
28304,"django-extensions","django-extensions",11,46,15,61,1811,"Python",439,250,689
28824,"cloudfoundry","cloud_controller_ng",104,331,21,352,623,"Ruby",2663,141,2804
29408,"OpenMRS","openmrs-module-xforms",11,11,0,11,619,"Java",363,12,375
29465,"unepwcmc","SAPI",13,912,89,1001,665,"Ruby",4735,249,4984
30178,"zendesk","zendesk_api_client_rb",100,44,2,46,812,"Ruby",623,45,668
30491,"spree","spree_gateway",13,27,7,34,808,"Ruby",271,81,352
30965,"hasgeek","hasjob",11,21,2,23,1050,"Python",344,27,371
31779,"travis-ci","travis-build",42,54,24,78,885,"Ruby",937,165,1102
31845,"nuxeo","nuxeo-distribution",22,120,1,121,812,"Java",1099,9,1108
31975,"nuxeo","nuxeo-quota",22,37,0,37,801,"Java",238,1,239
31995,"nuxeo","nuxeo-social-collaboration",22,15,0,15,1129,"Java",779,20,799
32076,"floodlight","oftest",34,16,16,32,785,"Python",391,102,493
32709,"jenkinsci","xunit-plugin",301,20,1,21,1178,"Java",440,16,456
33145,"thoughtbot","clearance",80,43,14,57,1989,"Ruby",661,161,822
33666,"axsh","wakame-vdc",16,33,3,36,1422,"Ruby",7290,289,7579
33858,"ceylon","ceylon.language",14,147,5,152,884,"Java",2063,33,2096
33958,"pyne","pyne",20,60,63,123,1041,"Python",1006,152,1158
34627,"aufdemrand","Denizen",14,129,72,201,732,"Java",2964,231,3195
34884,"kickstarter","slave_pools",26,14,2,16,758,"Ruby",149,4,153
35311,"puppetlabs","puppetlabs_spec_helper",74,3,7,10,805,"Ruby",49,52,101
35349,"lyonrb","biceps",21,12,1,13,888,"Ruby",71,4,75
35378,"sensu","sensu-community-plugins",15,111,76,187,812,"Ruby",514,464,978
35649,"gatein","gatein-portal",19,49,44,93,721,"Java",4187,798,4985
35704,"tinkerpop","blueprints",14,21,3,24,1487,"Java",1366,137,1503
35770,"rubygems","rubygems.org",33,53,10,63,1862,"Ruby",1141,232,1373
35846,"JetBrains","kotlin",20,2237,59,2296,752,"Java",18181,395,18576
37843,"DSpace","DSpace",26,84,60,144,720,"Java",4835,493,5328
38823,"sensu","sensu",15,8,7,15,969,"Ruby",1097,560,1657
38896,"dimagi","logistics",28,39,8,47,1123,"Python",3099,122,3221
40080,"concerto","concerto",13,244,28,272,1476,"Ruby",2588,167,2755
40428,"akvo","akvo-rsr",12,90,14,104,1557,"Python",1705,45,1750
40833,"MagLev","maglev",14,40,8,48,1865,"Ruby",4930,127,5057
40841,"99designs","vacuumetrix",24,5,6,11,626,"Ruby",50,14,64
40854,"enonic","cms-ce",12,109,0,109,1071,"Java",3613,617,4230
41004,"thoughtbot","factory_girl_rails",74,10,1,11,1382,"Ruby",133,46,179
41127,"4teamwork","ftw.book",14,96,7,103,822,"Python",694,33,727
41180,"4teamwork","ftw.blog",14,25,6,31,827,"Python",472,28,500
41197,"4teamwork","ftw.workspace",14,30,4,34,827,"Python",515,25,540
41465,"alphagov","business-support-finder",50,16,7,23,626,"Ruby",438,57,495
41601,"societies","SOCIETIES-Platform",57,24,0,24,874,"Java",4884,1,4885
41728,"praekelt","vumi",16,312,35,347,1207,"Python",5897,531,6428
42018,"pivotal","jasmine-gem",23,11,3,14,1526,"Ruby",266,117,383
42086,"opscode-cookbooks","apt",26,12,4,16,722,"Ruby",149,73,222
42087,"duckduckgo","zeroclickinfo-fathead",22,10,2,12,976,"Python",427,67,494
42120,"SonarCommunity","sonar-groovy",28,40,0,40,617,"Java",164,3,167
42335,"AIFDR","inasafe",17,470,28,498,787,"Python",4588,56,4644
42418,"DawnScience","dawn-isenciaui",12,15,0,15,779,"Java",108,2,110
42447,"robworth","patientview",11,180,20,200,652,"Java",1997,231,2228
42568,"4teamwork","ftw.upgrade",13,13,2,15,833,"Python",225,22,247
42734,"nuxeo","nuxeo-features",22,187,0,187,812,"Java",2236,14,2250
42750,"alphagov","panopticon",122,118,27,145,955,"Ruby",1311,134,1445
42812,"puppetlabs","puppetlabs-firewall",59,47,42,89,1034,"Ruby",217,229,446
42952,"alphagov","whitehall",123,1143,110,1253,899,"Ruby",19034,1294,20328
43727,"ipa320","cob_robots",44,5,7,12,864,"Python",447,138,585
43735,"intalio","tempo",23,7,15,22,1848,"Java",1730,138,1868
43858,"eaudeweb","cites-meetings",11,119,0,119,714,"Python",1109,16,1125
43875,"xwiki","xwiki-platform",18,575,11,586,1092,"Java",5063,264,5327
44108,"alphagov","slimmer",82,23,8,31,1058,"Ruby",517,60,577
44265,"seancribbs","webmachine-ruby",17,43,6,49,1008,"Ruby",241,101,342
44476,"SUSE","spacewalk-testsuite-base",13,40,4,44,680,"Ruby",418,4,422
44682,"mozilla-services","tokenserver",11,69,12,81,804,"Python",419,18,437
44967,"nuxeo","nuxeo",22,109,1,110,812,"Python",823,3,826
45316,"openSUSE","open-build-service",13,245,27,272,966,"Ruby",11570,355,11925
45348,"oe-alliance","enigma2-plugins",19,23,4,27,612,"Python",561,8,569
45527,"dimagi","rapidsms-logistics",20,19,6,25,973,"Python",505,24,529
45614,"puppetlabs","puppetlabs-apache",186,57,78,135,1282,"Ruby",398,508,906
45658,"cloudera","hue",34,288,2,290,1354,"Python",2217,23,2240
45947,"expertiza","expertiza",18,33,0,33,1248,"Ruby",2199,139,2338
46273,"jenkinsci","ec2-plugin",307,7,5,12,1178,"Java",123,77,200
46754,"vim-jp","vim-jp.github.com",34,45,1,46,903,"Ruby",676,11,687
46759,"A24Group","ssGWT-lib",16,7,4,11,639,"Java",431,222,653
47633,"jboss-switchyard","core",11,14,15,29,1323,"Java",260,603,863
48024,"xwiki","xwiki-commons",17,113,0,113,1098,"Java",1767,6,1773
48033,"NGDATA","lilyproject",13,22,0,22,640,"Java",1079,1,1080
48168,"openframeworks","ofSite",13,7,3,10,808,"Python",754,177,931
48485,"OpenGamma","OG-Platform",27,860,1,861,1260,"Java",12736,10,12746
48706,"learning-unlimited","ESP-Website",36,525,99,624,863,"Python",8292,406,8698
48764,"cucumber","cucumber-jvm",32,15,16,31,983,"Java",918,275,1193
49127,"tdiary","tdiary-core",13,33,8,41,1377,"Ruby",1388,148,1536
49649,"hasgeek","lastuser",10,33,3,36,1113,"Python",332,32,364
49895,"Catrobat","Paintroid",121,119,6,125,588,"Java",2383,125,2508
49956,"opscode","omnibus-chef",63,63,10,73,688,"Ruby",1160,121,1281
50013,"OpenSlides","OpenSlides",13,18,18,36,583,"Python",1567,465,2032
50119,"JetBrains","Grammar-Kit",13,18,1,19,945,"Java",385,8,393
50297,"Athas","EggsML",25,275,3,278,1409,"Python",4142,6,4148
50585,"lizardsystem","lizard-damage",13,13,1,14,584,"Python",409,1,410
50901,"Pylons","substanced",14,55,11,66,703,"Python",1215,75,1290
51690,"DawnScience","dawn-workflow",12,38,0,38,779,"Java",336,6,342
51802,"DawnScience","dawn-isencia",12,14,0,14,779,"Java",38,1,39
52612,"Kozea","pygal",15,40,4,44,895,"Python",489,29,518
53198,"IVPR","Weave",30,413,0,413,1044,"Java",3357,3,3360
53565,"mantidproject","systemtests",35,146,0,146,875,"Python",1019,1,1020
54795,"campaignmonitor","createsend-java",10,9,1,10,1103,"Java",151,8,159
54878,"imagej","imagej-tutorials",14,15,0,15,581,"Java",81,1,82
55068,"materialsproject","pymatgen",28,228,8,236,865,"Python",2241,48,2289
55219,"JetBrains","intellij-community",23,3248,17,3265,888,"Java",100164,151,100315
55816,"collective","collective.quickupload",256,12,0,12,745,"Python",177,22,199
56043,"4teamwork","ftw.tabbedview",14,10,1,11,828,"Python",510,23,533
56047,"itm","testbed-runtime",20,32,0,32,1366,"Java",1145,15,1160
56447,"cwi-swat","rascal",16,358,1,359,591,"Java",3347,23,3370
56551,"imagej","imagej",18,637,12,649,770,"Java",4735,22,4757
56941,"alphagov","signonotron2",126,290,66,356,701,"Ruby",1189,205,1394
57895,"CyanogenMod","android_packages_apps_CMWallpapers",86,19,0,19,1079,"Java",132,2,134
57932,"CyanogenMod","android_packages_apps_Torch",86,25,0,25,1305,"Java",232,14,246
58364,"openSUSE","software-o-o",28,10,0,10,869,"Ruby",467,20,487
58755,"geosolutions-it","geostore",12,9,2,11,678,"Java",93,4,97
58772,"plone","buildout.coredev",235,402,5,407,893,"Python",2400,44,2444
58827,"alphagov","gds-api-adapters",90,80,18,98,825,"Ruby",802,125,927
58896,"alphagov","govspeak",63,24,4,28,972,"Ruby",150,14,164
59344,"travis-ci","travis-hub",39,14,1,15,849,"Ruby",640,22,662
59350,"travis-ci","travis-worker",41,70,4,74,1004,"Ruby",1077,56,1133
59351,"travis-ci","travis-api",39,39,6,45,596,"Ruby",769,55,824
59490,"neo4j","spatial",28,7,3,10,1485,"Java",230,43,273
59519,"alphagov","frontend",131,196,41,237,912,"Ruby",3166,534,3700
59803,"plone","plone.app.portlets",234,47,3,50,893,"Python",470,34,504
59903,"societies","SOCIETIES-SCE-Services",34,16,0,16,839,"Java",802,4,806
60101,"Shopify","shopify_app",97,12,4,16,1974,"Ruby",131,44,175
60686,"jboss-reddeer","reddeer",16,61,68,129,590,"Java",382,355,737
60891,"codeforamerica","follow-all",62,46,1,47,1147,"Ruby",563,8,571
61494,"nuxeo","nuxeo-jsf",22,145,0,145,812,"Java",1442,5,1447
61551,"mfoemmel","fig",15,11,1,12,1527,"Ruby",483,5,488
62232,"buddycloud","buddycloud-media-server",15,58,0,58,668,"Java",210,13,223
62373,"ceylon","ceylon-compiler",20,119,2,121,1137,"Java",7671,142,7813
62852,"isfit","isfit.org",11,33,0,33,1260,"Ruby",533,1,534
63401,"datasift","datasift-java",21,24,0,24,1003,"Java",181,37,218
64212,"Pylons","colander",20,4,7,11,1114,"Python",153,104,257
64317,"plone","plone.app.users",149,32,4,36,893,"Python",274,18,292
64396,"DawnScience","dawn-product",12,20,0,20,779,"Java",275,1,276
64496,"mulesoft","mongo-connector",82,21,1,22,1081,"Java",272,7,279
64597,"openshift","jenkins-cloud-plugin",82,6,6,12,679,"Java",44,17,61
65187,"agiliq","merchant",12,8,5,13,1254,"Python",248,57,305
65288,"makerbot","pyserial",47,15,0,15,616,"Python",480,2,482
65321,"tomahawk-player","tomahawk-android",19,103,0,103,600,"Java",505,2,507
65747,"infochimps-labs","ironfan-pantry",10,48,4,52,754,"Ruby",1233,35,1268
66175,"mozilla","dxr",10,99,31,130,1017,"Python",482,231,713
67190,"railsbridge","docs",14,20,20,40,884,"Ruby",345,253,598
67424,"wordnik","swagger-codegen",24,40,25,65,974,"Java",584,79,663
67522,"griddynamics","jagger",20,70,53,123,752,"Java",563,401,964
67633,"mozilla-services","android-sync",10,563,45,608,870,"Java",4397,423,4820
67640,"rightscale","right_support",127,80,17,97,1091,"Ruby",655,121,776
67874,"openmicroscopy","openmicroscopy",50,213,211,424,931,"Java",14045,2139,16184
68102,"enthought","enstaller",74,194,21,215,1142,"Python",1385,138,1523
68430,"mulesoft","facebook-connector",97,10,0,10,1053,"Java",171,1,172
68610,"belaban","JGroups",11,100,12,112,1215,"Java",16139,128,16267
69299,"nuxeo","nuxeo-drive",22,291,0,291,643,"Python",1632,6,1638
69314,"plone","plone.app.layout",235,31,5,36,893,"Python",514,33,547
69357,"mozilla","solitude",25,21,14,35,639,"Python",531,200,731
69792,"rhomobile","rhomobile-docs",33,122,4,126,1133,"Ruby",1384,79,1463
70254,"JFrogDev","artifactory-client-java",12,7,3,10,589,"Java",103,23,126
70387,"hasgeek","hasgeek.tv",11,12,0,12,819,"Python",506,63,569
70480,"Jasig","uPortal",25,246,61,307,868,"Java",10755,258,11013
70634,"pentaho","mondrian",50,21,17,38,717,"Java",3736,221,3957
70769,"alphagov","rummager",112,53,14,67,856,"Ruby",1654,190,1844
70783,"codeforamerica","adopt-a-hydrant",51,36,1,37,1116,"Ruby",669,18,687
70797,"mulesoft","s3-connector",99,13,0,13,1154,"Java",257,5,262
70839,"mulesoft","salesforce-connector",88,43,1,44,1119,"Java",464,14,478
71334,"ceph","teuthology",49,528,44,572,909,"Python",3223,214,3437
71374,"pentaho","data-access",51,10,13,23,916,"Java",811,393,1204
72063,"splunk","splunk-sdk-java",58,11,1,12,1021,"Java",806,49,855
72578,"psu-stewardship","scholarsphere",10,66,0,66,889,"Ruby",1502,6,1508
73635,"digitalgreenorg","dg",12,249,20,269,848,"Java",3618,186,3804
73747,"wwagner33","solar",24,127,0,127,1203,"Ruby",1236,2,1238
74063,"opscode","omnibus-ruby",46,97,15,112,751,"Ruby",612,99,711
74349,"ella","ella",11,9,1,10,1841,"Python",626,49,675
75274,"collective","eea.facetednavigation",256,18,1,19,765,"Python",226,13,239
75605,"commonsense","conceptnet5",32,43,1,44,897,"Python",211,1,212
75619,"fiji","fiji",11,196,8,204,1058,"Java",2193,47,2240
75812,"opscode","omnibus-software",81,115,19,134,689,"Ruby",608,115,723
75832,"ooici","ion-ux",43,103,89,192,847,"Python",1568,337,1905
76547,"rightscale","right_api_client",64,37,5,42,1228,"Ruby",215,30,245
78275,"coshx","coshx",15,62,13,75,924,"Ruby",741,17,758
78393,"sonatype","sisu-guice",27,12,1,13,1282,"Java",215,3,218
79429,"exoplatform","docs-style",10,15,0,15,701,"Java",280,67,347
81325,"plone","plone.app.discussion",231,21,3,24,893,"Python",488,39,527
81423,"mozilla-services","docs",22,18,0,18,765,"Python",295,8,303
82195,"mozilla","Addon-Tests",40,9,6,15,1030,"Python",1173,668,1841
83095,"opscode","knife-azure",71,51,11,62,638,"Ruby",582,127,709
84749,"tomahawk-player","homebrew-tomahawk",19,10,0,10,679,"Ruby",71,2,73
84985,"exoplatform","integration",10,15,10,25,701,"Java",319,89,408
86192,"plone","plone.app.contentrules",149,10,1,11,893,"Python",212,5,217
86465,"nuxeo","nuxeo-chemistry",22,19,0,19,812,"Java",426,6,432
86469,"nuxeo","nuxeo-platform-faceted-search",22,16,0,16,812,"Java",367,1,368
86589,"4teamwork","ftw.pdfgenerator",13,27,7,34,848,"Python",296,12,308
86681,"nuxeo","nuxeo-platform-user-registration",22,10,0,10,812,"Java",138,1,139
87535,"nuxeo","nuxeo-opensocial",22,23,0,23,812,"Java",412,5,417
88971,"nuxeo","nuxeo-dm",22,123,0,123,812,"Java",1147,7,1154
89329,"nuxeo","nuxeo-services",22,55,0,55,812,"Java",784,12,796
90432,"ceph","ceph-cookbooks",30,8,14,22,904,"Ruby",195,86,281
90565,"nuxeo","nuxeo-agenda",22,10,1,11,688,"Java",118,1,119
91064,"rapid7","nexpose-client",42,18,2,20,867,"Ruby",312,16,328
92010,"sot","eng_archive",10,62,6,68,960,"Python",400,29,429
92224,"genome","dgi-db",41,37,2,39,633,"Ruby",759,2,761
92535,"molgenis","molgenis",31,155,155,310,1353,"Java",1620,986,2606
94297,"opscode-cookbooks","yum",26,57,6,63,722,"Ruby",239,69,308
94375,"sonatype","nexus-maven-plugins",30,26,2,28,630,"Java",474,47,521
95180,"rcbops-cookbooks","horizon",21,7,9,16,702,"Ruby",114,152,266
95329,"plasmodic","ecto",10,23,0,23,1015,"Python",402,47,449
96622,"causes","mock_redis",39,12,1,13,973,"Ruby",108,57,165
97464,"mongodb","docs-ecosystem",47,10,15,25,625,"Python",282,140,422
102437,"plone","plone.app.controlpanel",231,48,4,52,893,"Python",565,21,586
103508,"HUSACCT","HUSACCT",14,40,0,40,715,"Java",1431,187,1618
103713,"sonian","elasticsearch-jetty",27,13,2,15,906,"Java",139,31,170
104115,"saga-project","BigJob",10,28,0,28,793,"Python",801,1,802
104697,"xwiki","xwiki-enterprise",17,40,0,40,1094,"Java",2654,57,2711
105576,"xwiki","xwiki-rendering",17,20,0,20,1106,"Java",449,8,457
105762,"akvo","akvo-flow",13,104,3,107,709,"Java",1771,5,1776
107290,"alethiophile","KBDH-VN",13,13,0,13,728,"Python",845,4,849
107969,"jenkinsci","jclouds-plugin",313,19,10,29,1179,"Java",258,59,317
111425,"r888888888","danbooru",18,87,0,87,1491,"Ruby",1914,31,1945
112319,"JFrogDev","build-info",12,12,0,12,1110,"Java",402,28,430
112751,"rails","sprockets-rails",32,9,5,14,1019,"Ruby",112,59,171
115228,"Qi4j","qi4j-sdk",16,112,2,114,1195,"Java",703,21,724
116115,"plone","plone.app.multilingual",235,22,1,23,980,"Python",453,45,498
118301,"railsgirls","railsgirls.github.com",242,35,23,58,687,"Ruby",274,137,411
119078,"collectiveidea","tinder",12,12,2,14,2217,"Ruby",144,33,177
120232,"droolsjbpm","droolsjbpm-integration",37,131,3,134,1116,"Java",861,78,939
122473,"vmware-serengeti","serengeti-ws",26,62,0,62,635,"Java",1129,2,1131
122606,"zkoss","zk",17,31,2,33,1021,"Java",804,54,858
123437,"saltstack","salt-contrib",18,14,6,20,836,"Python",85,62,147
123568,"oe-alliance","oe-alliance-plugins",20,44,1,45,617,"Python",543,11,554
123745,"jenkinsci","promoted-builds-plugin",317,10,6,16,1179,"Java",144,39,183
125032,"plone","Products.Archetypes",234,15,4,19,889,"Python",471,38,509
125357,"DawnScience","dawn-common",12,94,0,94,779,"Java",964,5,969
125673,"lizardsystem","lizard-map",15,35,5,40,888,"Python",741,14,755
126795,"HiSPARC","publicdb",12,53,1,54,749,"Python",896,4,900
126912,"Connexions","oer.exports",24,181,20,201,624,"Python",1686,171,1857
128005,"Talend","tesb-rt-se",66,23,1,24,1168,"Java",986,21,1007
128476,"alphagov","imminence",93,10,5,15,946,"Ruby",657,84,741
128620,"ceylon","ceylon-module-resolver",14,9,1,10,832,"Java",405,5,410
128749,"mozilla","mozmill-ci",41,4,9,13,804,"Python",257,220,477
130401,"exoplatform","calendar",14,12,2,14,651,"Java",272,52,324
132014,"12spokes","tandem",11,8,3,11,1462,"Ruby",430,72,502
132590,"ooici","marine-integrations",10,24,12,36,682,"Python",1122,146,1268
134768,"conversation","babushka-deps",12,16,0,16,1093,"Ruby",628,1,629
135818,"unicefuganda","rapidsms-ureport",11,55,7,62,933,"Python",977,9,986
137149,"causes","buffet",26,11,0,11,973,"Ruby",225,2,227
138238,"bcdev","beam",15,237,0,237,1479,"Java",2991,5,2996
140309,"lizardsystem","lizard-fewsjdbc",16,13,3,16,661,"Python",241,5,246
140647,"4teamwork","ftw.poodle",14,16,2,18,826,"Python",217,12,229
141140,"mindsnacks","Zinc",19,23,2,25,735,"Python",415,24,439
141345,"torchbox","vagrant-django-template",13,10,2,12,751,"Python",73,4,77
141358,"4teamwork","ftw.table",14,8,2,10,1077,"Python",516,24,540
141927,"rubyspec","rubyspec",39,32,3,35,2104,"Ruby",6483,217,6700
142225,"xebialabs","community-plugins",13,11,6,17,897,"Java",412,45,457
142238,"BroadleafCommerce","blc-authorizenet",12,17,0,17,577,"Java",100,1,101
142306,"BroadleafCommerce","blc-paypal",12,27,0,27,577,"Java",92,3,95
142564,"jenkinsci","perforce-plugin",317,20,3,23,1179,"Java",170,40,210
143729,"threerings","clyde",16,64,0,64,1051,"Java",631,4,635
144230,"enStratus","documentation",11,12,1,13,687,"Python",379,19,398
144429,"OpenMRS","openmrs-module-reporting",33,89,12,101,625,"Java",622,73,695
145091,"plone","archetypes.referencebrowserwidget",236,11,0,11,897,"Python",216,13,229
145822,"mysociety","mapit",22,15,2,17,1353,"Python",522,25,547
146799,"plone","plonetheme.sunburst",235,11,1,12,893,"Python",379,13,392
146900,"infochimps-labs","vayacondios",10,100,2,102,1028,"Ruby",464,4,468
147172,"recurly","recurly-client-ruby",10,20,7,27,1565,"Ruby",250,70,320
150461,"fusesource","mqtt-client",22,19,2,21,810,"Java",70,4,74
152604,"pbs","pycaption",53,11,9,20,643,"Python",71,22,93
152649,"Ilastik","volumina",21,32,1,33,975,"Python",808,21,829
152921,"plone","plone.app.dexterity",234,24,6,30,898,"Python",238,42,280
153944,"webdetails","cpf",12,8,8,16,730,"Java",471,14,485
154208,"alphagov","licence-finder",90,14,7,21,679,"Ruby",500,53,553
154882,"isfit","internal.isfit.org",12,62,6,68,977,"Ruby",652,11,663
155751,"ranguba","rroonga",15,61,1,62,1416,"Ruby",874,11,885
156467,"rightscale","right_agent",75,94,12,106,1010,"Ruby",557,103,660
156699,"JFXtras","jfxtras-labs",16,33,6,39,752,"Java",599,56,655
158057,"data-axle","cassandra_object",13,46,3,49,1182,"Ruby",335,24,359
158071,"jboss-switchyard","release",11,10,11,21,1011,"Java",198,336,534
160532,"couchbase","couchbase-java-client",49,21,0,21,835,"Java",281,2,283
160833,"foursquare","twofishes",34,43,4,47,748,"Java",939,16,955
161036,"thoughtbot","neat",50,10,6,16,581,"Ruby",307,54,361
161140,"rs-services","cookbooks_internal",35,27,0,27,1157,"Ruby",1224,2,1226
161254,"collective","collective.cover",420,30,3,33,871,"Python",1628,136,1764
162539,"rosedu","wouso",11,33,7,40,815,"Python",1657,137,1794
163173,"Jasig","CalendarPortlet",17,10,2,12,722,"Java",52,21,73
163853,"novoda","SQLiteProvider",14,28,6,34,1209,"Java",89,13,102
164170,"socialcast","socialcast-command-line",29,24,0,24,1364,"Ruby",168,21,189
165427,"sot","xija",10,9,2,11,1030,"Python",188,9,197
168215,"plone","plone.app.contenttypes",236,150,13,163,850,"Python",606,49,655
168886,"lizardsystem","flooding-lib",15,42,0,42,636,"Python",703,5,708
169529,"phpmyadmin","website",10,23,0,23,760,"Python",577,10,587
169932,"racker","rackspace-monitoring-cli",130,9,8,17,816,"Python",205,34,239
170425,"enthought","encore",55,12,6,18,818,"Python",198,64,262
170802,"plone","plone.app.workflowmanager",236,16,1,17,837,"Python",57,14,71
172825,"alphagov","trade-tariff-backend",113,121,14,135,661,"Ruby",1889,143,2032
178035,"abiquo","commons-amqp",27,8,3,11,899,"Java",292,10,302
184142,"jenkinsci","mercurial-plugin",298,20,9,29,1179,"Java",227,55,282
185366,"alphagov","smokey",101,35,10,45,841,"Ruby",539,67,606
188939,"Slowpoke101","FTBLaunch",14,70,33,103,573,"Java",386,194,580
190783,"alphagov","trade-tariff-frontend",97,26,13,39,661,"Ruby",1234,117,1351
194056,"DIRACGrid","VMDIRAC",22,4,9,13,863,"Python",198,50,248
195656,"bcdev","ceres",11,29,0,29,1479,"Java",1153,3,1156
196147,"projecthydra","hydra-head",22,54,17,71,1091,"Ruby",1155,110,1265
198021,"Kozea","Multicorn",15,34,2,36,1005,"Python",504,18,522
201224,"enthought","traitsui",74,13,7,20,1053,"Python",1045,106,1151
202365,"thoughtbot","appraisal",65,20,0,20,1211,"Ruby",286,36,322
204403,"mysociety","whatdotheyknow-theme",22,26,3,29,996,"Ruby",374,30,404
208674,"nuxeo","nuxeo-platform-login",22,16,0,16,812,"Java",380,6,386
209250,"mozilla","mozillians-tests",42,13,15,28,888,"Python",142,113,255
210280,"saucelabs","sauce-java",10,15,4,19,631,"Java",122,4,126
211549,"Freeseer","freeseer",23,67,34,101,1556,"Python",2570,147,2717
213686,"zilkey","active_hash",21,12,5,17,1688,"Ruby",179,34,213
213856,"iFixit","git-scripts",20,27,7,34,776,"Ruby",490,78,568
218083,"pm4j","org.pm4j",11,82,1,83,788,"Java",764,2,766
218181,"openmicroscopy","ome-documentation",41,86,84,170,779,"Python",1479,688,2167
219631,"jenkinsci","integrity-plugin",296,12,2,14,1101,"Java",106,5,111
230938,"jenkinsci","analysis-core-plugin",301,12,0,12,1179,"Java",200,20,220
230968,"ros","genpy",12,9,2,11,845,"Python",187,18,205
231370,"mozilla","moztrap-tests",42,5,5,10,904,"Python",173,120,293
232705,"opscode","knife-windows",60,7,9,16,1098,"Ruby",128,68,196
234674,"plone","plone.app.upgrade",149,50,2,52,893,"Python",288,16,304
235039,"BlueKai","bluekai_middleware",27,12,2,14,666,"Ruby",97,14,111
241678,"id774","automaticruby",12,32,0,32,746,"Ruby",263,22,285
242675,"xebia","Xebium",92,9,1,10,1239,"Java",154,18,172
247032,"metsci","glimpse",11,19,0,19,728,"Java",171,1,172
252194,"jubatus","jubatus-java-client",14,6,4,10,692,"Java",84,18,102
252680,"aerogear","aerogear-android",13,77,9,86,605,"Java",802,139,941
253596,"droolsjbpm","droolsjbpm-tools",37,12,1,13,1120,"Java",422,30,452
256086,"bitcoin","bitcoin.org",10,114,28,142,918,"Ruby",1243,250,1493
257425,"inviqa","chef-magento",57,9,6,15,598,"Ruby",168,54,222
261125,"CocoaPods","Xcodeproj",31,12,2,14,850,"Ruby",433,53,486
270016,"leonardofl","radar_parlamentar",17,18,3,21,818,"Python",582,28,610
274836,"jenkinsci","email-ext-plugin",311,37,4,41,1179,"Java",299,84,383
278099,"jcryptool","crypto",12,18,0,18,938,"Java",773,3,776
285763,"tillnagel","unfolding",12,48,0,48,695,"Java",783,5,788
288440,"alphagov","EFG",101,94,16,110,660,"Ruby",2558,195,2753
289935,"mkovatsc","Californium",10,22,1,23,1088,"Java",761,20,781
291425,"jenkinsci","starteam-plugin",301,10,1,11,1179,"Java",315,9,324
292891,"alphagov","design-principles",117,78,29,107,720,"Ruby",1106,145,1251
294678,"4teamwork","ftw.notification.base",14,8,2,10,826,"Python",175,9,184
295815,"dimagi","casexml",19,229,43,272,1009,"Python",1166,191,1357
306638,"dimagi","dimagi-utils",19,17,7,24,1273,"Python",727,180,907
307422,"droolsjbpm","jbpm-console-ng",36,91,2,93,570,"Java",731,64,795
309466,"opscode","bento",62,22,24,46,729,"Ruby",184,178,362
309847,"threerings","tripleplay",16,57,0,57,993,"Java",997,7,1004
313109,"sonatype","sisu-goodies",28,18,2,20,855,"Java",309,21,330
322949,"opscode-cookbooks","firewall",26,10,6,16,722,"Ruby",44,19,63
324846,"transmart","Rmodules",11,23,2,25,681,"Java",94,6,100
326632,"omaciel","robottelo",12,195,124,319,693,"Python",579,263,842
331002,"janfaessler","FHNW-Informatik-Zusammenfassungen",14,24,1,25,717,"Java",288,24,312
333400,"jclouds","jclouds-examples",19,8,3,11,1121,"Java",165,34,199
333984,"alphagov","gds-sso",55,36,8,44,974,"Ruby",306,37,343
344679,"plone","Products.ATContentTypes",149,9,1,10,838,"Python",213,5,218
344973,"plone","plone.app.z3cform",149,14,1,15,898,"Python",187,14,201
347655,"acm-uiuc","liquid",11,32,18,50,819,"Python",431,117,548
352633,"rapid7","metasploit_data_models",32,36,5,41,797,"Ruby",511,55,566
352799,"alphagov","calendars",90,13,6,19,849,"Ruby",501,54,555
356033,"mojolingo","Telephony-Dev-Box",11,10,0,10,909,"Ruby",223,12,235
359432,"ooici","coverage-model",20,24,12,36,603,"Python",470,148,618
361214,"phoet","on_ruby",10,37,3,40,1179,"Ruby",863,44,907
380886,"mulesoft","dropbox-connector",74,11,0,11,882,"Java",53,2,55
394661,"devbliss","apitester",32,27,1,28,609,"Java",125,4,129
395882,"bebanjo","almodovar",16,8,2,10,1428,"Ruby",133,7,140
400044,"Freeseer","freeseer-docs",16,35,3,38,714,"Python",266,33,299
401284,"mysociety","theyworkforyou",20,440,14,454,1492,"Python",1265,49,1314
407274,"ros","catkin",13,85,17,102,850,"Python",1750,225,1975
414409,"StratusLab","client",12,72,2,74,683,"Python",615,2,617
421417,"jcb","CSIRL",10,30,0,30,820,"Python",163,3,166
443327,"jenkinsci","monitoring-plugin",310,14,1,15,1179,"Java",240,2,242
456655,"intalio","security",23,2,18,20,1836,"Java",153,59,212
458061,"lizardsystem","lizard-progress",15,48,3,51,762,"Python",491,14,505
462902,"nuxeo","nuxeo-platform-importer",22,9,1,10,812,"Java",220,4,224
477331,"okfn","ckanext-datahub",13,11,1,12,685,"Python",113,7,120
483343,"alphagov","govuk_content_api",100,92,25,117,633,"Ruby",864,167,1031
497205,"ctn-waterloo","nengo",25,107,18,125,868,"Python",1737,140,1877
504488,"jenkinsci","dry-plugin",308,10,0,10,1178,"Java",150,2,152
508238,"mapserver","msautotest",15,14,0,14,702,"Python",364,25,389
511754,"paulelliott","authem",10,25,1,26,841,"Ruby",136,15,151
517631,"puppetlabs","packaging",171,36,28,64,587,"Ruby",331,273,604
519893,"nuxeo","nuxeo-platform-suggestbox",22,10,0,10,863,"Java",168,1,169
530921,"openplanets","jpylyzer",37,49,0,49,764,"Python",216,3,219
546037,"owncloud","android",42,335,39,374,558,"Java",1238,137,1375
599522,"zenoss","ZenPacks.zenoss.OpenStack",22,17,1,18,1016,"Python",89,2,91
614053,"mysociety","alaveteli",31,161,15,176,1192,"Ruby",5553,300,5853
619778,"Sage-Bionetworks","schema-to-pojo",13,5,5,10,661,"Java",91,7,98
622343,"plone","plone.namedfile",234,25,1,26,898,"Python",142,8,150
628032,"thoughtbot","shoulda-context",68,13,1,14,1177,"Ruby",61,21,82
643805,"alphagov","feedback",66,79,19,98,553,"Ruby",575,117,692
674069,"collective","plone.app.locales",261,11,1,12,551,"Python",313,29,342
692866,"ArcBees","GWTP",21,109,21,130,548,"Java",1481,217,1698
696536,"SeqWare","seqware",15,60,8,68,664,"Java",2356,172,2528
699315,"buddycloud","channel-directory",16,11,0,11,1044,"Java",77,1,78
700952,"AF83","desi",21,17,2,19,547,"Ruby",103,2,105
706524,"TMXCredit","pg_power",14,33,6,39,786,"Ruby",159,36,195
731329,"nuxeo","nuxeo-dam",22,20,0,20,827,"Java",567,2,569
749842,"plone","jenkins.plone.org",171,41,0,41,846,"Python",132,2,134
768967,"collective","collective.recipe.rsync",264,27,0,27,877,"Python",104,4,108
777221,"alphagov","support",105,76,23,99,541,"Ruby",1011,141,1152
801441,"Activiti","Activiti",19,128,32,160,539,"Java",3339,192,3531
805394,"collective","Products.feedfeeder",265,10,0,10,540,"Python",123,3,126
805498,"ceph","ceph-deploy",37,18,17,35,540,"Python",434,164,598
824970,"SimTk","msmbuilder",17,152,46,198,553,"Python",1051,133,1184
825924,"unknown-horizons","unknown-horizons",35,96,11,107,1291,"Python",8490,244,8734
834289,"plone","plone.app.testing",176,25,0,25,893,"Python",182,5,187
834358,"jenkinsci","sauce-ondemand-plugin",306,32,0,32,1179,"Java",236,2,238
857627,"square","dagger",15,22,8,30,581,"Java",482,237,719
858413,"mulesoft","sqs-connector",87,10,0,10,860,"Java",99,5,104
878519,"hhru","tornado",41,15,2,17,1283,"Python",241,7,248
882004,"mulesoft","munit",82,59,1,60,740,"Java",368,21,389
896266,"spotify","luigi",101,21,29,50,532,"Python",364,230,594
899831,"Activiti","Activiti-Designer",11,20,1,21,532,"Java",242,8,250
913688,"mulesoft","mule-common",79,90,1,91,535,"Java",303,5,308
914064,"DataDog","documentation",12,41,9,50,815,"Ruby",473,44,517
930566,"railsforcharity","spokenvote",11,28,8,36,529,"Ruby",399,272,671
931243,"liqd","adhocracy",12,309,75,384,529,"Python",4527,363,4890
937082,"lizardsystem","lizard-rainapp",13,17,2,19,661,"Python",120,2,122
944137,"mapmyfitness","python-zuora",10,41,2,43,531,"Python",179,3,182
954912,"metamx","http-client",14,14,2,16,996,"Java",104,3,107
956098,"autotest","virt-test",25,507,155,662,527,"Python",4192,1255,5447
978319,"perfectsense","dari",44,76,1,77,526,"Java",973,3,976
978965,"perfectsense","brightspot-cms",44,309,0,309,526,"Java",1939,1,1940
988294,"facebook","swift",17,7,13,20,666,"Java",206,148,354
990455,"pbs","django-cms-dbtemplates",42,16,3,19,883,"Python",198,20,218
1021876,"wf4ever","astrotaverna",25,30,1,31,694,"Java",234,1,235
1028405,"openshift","origin-dev-tools",155,27,22,49,532,"Ruby",205,130,335
1042189,"mozilla","webpay",30,93,34,127,521,"Python",782,402,1184
1097375,"mozilla-services","wimms",11,9,1,10,734,"Python",63,2,65
1199766,"iGoDigital-LLC","stages",11,9,1,10,784,"Ruby",115,4,119
1292559,"owncloud","documentation",167,147,39,186,496,"Python",862,162,1024
1344612,"scikit-image","scikit-image",12,26,24,50,973,"Python",1188,692,1880
1344878,"opscode","chef-docs",75,568,9,577,605,"Python",3301,182,3483
1347553,"openshift","origin-server",139,801,457,1258,684,"Ruby",7014,4836,11850
1350393,"metamx","druid",20,319,48,367,499,"Java",2529,286,2815
1358732,"qiime","qiime",28,19,22,41,508,"Python",3767,500,4267
1361512,"rackspace","pyrax",12,31,19,50,525,"Python",488,126,614
1366147,"neo4j","neo4j",29,316,220,536,479,"Java",7057,1253,8310
1366976,"LiveRamp","hank",10,16,2,18,1126,"Java",473,13,486
1381021,"gitlabhq","gitlab-ci",14,95,14,109,512,"Ruby",423,149,572
1392964,"kijiproject","kijiproject.github.com",18,13,0,13,477,"Ruby",410,103,513
1393059,"kijiproject","kiji-schema",18,22,0,22,477,"Java",526,198,724
1393874,"imvu","imvujs",62,19,0,19,622,"Python",610,1,611
1397979,"aws","aws-sdk-ruby",22,44,17,61,966,"Ruby",717,262,979
1403672,"menro","NewTech",17,51,1,52,477,"Ruby",446,14,460
1420893,"nuxeo","NuxeoTraining",22,33,0,33,636,"Java",295,8,303
1426802,"lspecia","quest",18,11,0,11,511,"Java",311,1,312
1433342,"4teamwork","ftw.contentpage",19,57,10,67,492,"Python",784,125,909
1448496,"sc3","cookcountyjail",10,15,15,30,472,"Python",241,148,389
1502958,"4teamwork","ftw.participation",14,42,3,45,826,"Python",240,21,261
1503167,"endosnipe","ENdoSnipe",30,39,23,62,483,"Java",588,247,835
1504740,"Connexions","webview",20,321,34,355,601,"Python",1774,225,1999
1517998,"plivo","plivo-java",10,42,0,42,899,"Java",271,8,279
1533497,"mulesoft","google-connectors-suite",85,21,1,22,482,"Java",291,3,294
1545591,"opf","openproject",18,1657,204,1861,463,"Ruby",11723,992,12715
1561176,"jkelabora","rhok-plan-generator",13,42,0,42,460,"Ruby",306,9,315
1611658,"mozilla","MakeAPI",26,34,13,47,469,"Python",264,196,460
1639388,"Bigpoint","icinga",50,175,10,185,525,"Ruby",668,105,773
1686129,"plataformatec","faraday-http-cache",28,23,2,25,758,"Ruby",217,17,234
1711636,"dianping","cat",14,12,11,23,456,"Java",919,213,1132
1756850,"Alfresco","alfresco-android-app",31,16,15,31,570,"Java",259,183,442
1803672,"mulesoft","mule",39,508,170,678,454,"Java",14975,432,15407
1881412,"4teamwork","ftw.publisher.core",14,14,2,16,1081,"Python",188,12,200
1912872,"aws","aws-cli",22,97,41,138,471,"Python",588,258,846
1922523,"balanced","balanced-docs",14,98,10,108,448,"Python",563,142,705
1931310,"pentaho","pentaho-commons-gwt-modules",49,5,7,12,636,"Java",741,227,968
1938026,"okfn","ckanext-iati",14,13,3,16,842,"Python",582,9,591
1938308,"pbs","cmsplugin-feed",50,16,1,17,477,"Python",51,5,56
1944625,"mulesoft","box-connector",87,12,0,12,735,"Java",149,1,150
1967265,"CodeMontageHQ","codemontage",14,19,55,74,421,"Ruby",131,157,288
1989295,"collective","collective.usermanual",320,15,1,16,474,"Python",75,1,76
1989677,"pentaho","pentaho-platform",49,183,163,346,636,"Java",2501,1278,3779
2264276,"rcbops-cookbooks","nova-network",16,24,24,48,447,"Ruby",210,127,337
2291113,"pentaho","pentaho-reporting",49,31,30,61,422,"Java",939,330,1269
2294498,"lisa-lab","pylearn2",12,117,133,250,1200,"Python",751,494,1245
2367064,"asciidoctor","asciidoctor",38,101,22,123,643,"Ruby",588,400,988
2369446,"DirectEmployers","MyJobs",14,402,62,464,829,"Python",3024,518,3542
2377334,"forcedotcom","phoenix",35,84,15,99,413,"Java",1083,271,1354
2466155,"cubesystems","releaf",11,20,1,21,423,"Ruby",1219,4,1223
2488944,"Netflix","RxJava",14,181,156,337,422,"Java",822,607,1429
2565868,"futures","fcrepo4",10,58,43,101,396,"Java",2097,240,2337
2892743,"Tribler","tribler",16,104,90,194,374,"Python",5673,294,5967
2909103,"praekelt","vumi-go",17,283,44,327,986,"Python",6924,712,7636
3055228,"Parquet","parquet-mr",13,49,23,72,378,"Java",1116,234,1350
3056066,"ruby","www.ruby-lang.org",41,226,90,316,946,"Ruby",1506,482,1988
3056652,"gittip","www.gittip.com",35,533,123,656,643,"Python",2812,492,3304
3074577,"RiotGames","ridley",15,26,14,40,574,"Ruby",535,193,728
3105682,"camptocamp","c2cgeoportal",26,345,57,402,820,"Python",3068,669,3737
3213962,"rackerlabs","stacktach",231,36,35,71,547,"Python",252,286,538
3216686,"rackerlabs","repose",227,563,65,628,979,"Java",2346,884,3230
3219077,"learningequality","ka-lite",18,271,125,396,543,"Python",1285,685,1970
3263294,"hylang","hy",14,54,72,126,446,"Python",512,308,820
3411412,"RedHatQE","cfme_tests",17,245,243,488,393,"Python",696,440,1136
3411703,"projecthydra","sufia",20,46,29,75,414,"Ruby",848,262,1110
3604984,"mdsol","crichton",356,155,36,191,393,"Ruby",1155,133,1288
3821279,"zanata","zanata-server",14,338,50,388,1092,"Java",6856,384,7240
3825551,"bundler","bundler",25,121,47,168,1500,"Ruby",627,703,1330
3929150,"Octokit","octokit.rb",24,52,32,84,1547,"Ruby",430,280,710
3963440,"rackerlabs","otter",30,249,56,305,517,"Python",3539,570,4109
4385919,"azavea","OTM2",20,128,66,194,380,"Python",835,560,1395
4571553,"playframework","play1",18,13,16,29,1301,"Python",1521,736,2257
4616106,"aipocom","aipo",25,513,42,555,372,"Java",5212,194,5406
4835098,"mysociety","pombola",30,529,51,580,976,"Python",2380,174,2554
