'"`id`"','"`name`"','"`count(user_id)`"','commits last month','pull reqs last month','changesLastMonth','"`age_in_days`"','"`language`"','commits all','pull reqs all','totalChanges'
'"8"','"ncs_navigator_core"','"16"',0,0,0,'"686"','"Ruby"',5547,298,5845
'"34"','"android"','"37"',2,5,7,'"910"','"Java"',1735,174,1909
'"63"','"unisubs"','"15"',298,41,339,'"930"','"Python"',7540,330,7870
'"118"','"cancan"','"13"',0,4,4,'"1570"','"Ruby"',129,189,318
'"127"','"addon-sdk"','"17"',89,87,176,'"1345"','"Python"',2617,1420,4037
'"142"','"cron"','"26"',1,3,4,'"722"','"Ruby"',31,21,52
'"190"','"SimianArmy"','"47"',7,8,15,'"608"','"Java"',174,95,269
'"310"','"grape"','"14"',22,22,44,'"1312"','"Ruby"',462,306,768
'"312"','"katello"','"36"',344,224,568,'"693"','"Ruby"',15523,3462,18985
'"340"','"netty"','"16"',605,70,675,'"1213"','"Java"',7717,742,8459
'"343"','"azure-sdk-for-java"','"26"',0,0,0,'"821"','"Java"',850,178,1028
'"381"','"imagefactory"','"40"',0,0,0,'"1150"','"Python"',732,230,962
'"418"','"sunpy"','"15"',101,104,205,'"943"','"Python"',1312,549,1861
'"427"','"hw2_rottenpotatoes"','"18"',0,0,0,'"766"','"Ruby"',41,4,45
'"474"','"mozbase"','"17"',40,3,43,'"891"','"Python"',517,56,573
'"489"','"active_merchant"','"273"',123,73,196,'"2116"','"Ruby"',1270,840,2110
'"587"','"heroku-buildpack-ruby"','"44"',231,30,261,'"1017"','"Ruby"',1113,143,1256
'"608"','"errbit"','"10"',19,26,45,'"1310"','"Ruby"',567,398,965
'"613"','"Terasology"','"64"',315,129,444,'"1098"','"Java"',1396,414,1810
'"657"','"spree_reviews"','"33"',64,13,77,'"757"','"Ruby"',228,74,302
'"687"','"launchpad"','"10"',106,41,147,'"654"','"Python"',777,109,886
'"714"','"puppet-docs"','"150"',202,22,224,'"1269"','"Ruby"',1757,288,2045
'"750"','"rosdistro"','"18"',598,563,1161,'"785"','"Python"',4261,3222,7483
'"772"','"socorro"','"18"',140,160,300,'"925"','"Python"',2277,1927,4204
'"774"','"Socorro-Tests"','"40"',7,10,17,'"1035"','"Python"',247,237,484
'"807"','"bioformats"','"47"',106,127,233,'"884"','"Java"',9483,961,10444
'"810"','"metanl"','"35"',3,0,3,'"738"','"Python"',160,7,167
'"847"','"puppet"','"195"',292,189,481,'"1269"','"Ruby"',10015,2407,12422
'"852"','"ey-cloud-recipes"','"96"',3,6,9,'"1840"','"Ruby"',255,120,375
'"853"','"metasploit-framework"','"65"',213,231,444,'"919"','"Ruby"',16117,2982,19099
'"860"','"bedrock"','"18"',290,193,483,'"1057"','"Python"',3616,1720,5336
'"868"','"pivotal_workstation"','"28"',0,0,0,'"1122"','"Ruby"',252,222,474
'"937"','"grails-core"','"11"',380,26,406,'"1485"','"Java"',8274,460,8734
'"961"','"ipython"','"14"',293,250,543,'"1396"','"Python"',8371,2591,10962
'"1004"','"chirpradio-machine"','"10"',70,0,70,'"913"','"Python"',146,0,146
'"1005"','"puppet-acceptance"','"190"',1,0,1,'"1325"','"Ruby"',635,511,1146
'"1008"','"zf2-documentation"','"12"',158,33,191,'"605"','"Python"',2042,1113,3155
'"1065"','"djangotoolbox"','"13"',0,0,0,'"832"','"Python"',160,20,180
'"1113"','"travis-core"','"39"',149,32,181,'"850"','"Ruby"',2541,291,2832
'"1142"','"salt"','"15"',1350,865,2215,'"1110"','"Python"',14277,6545,20822
'"1282"','"pyramid"','"19"',48,20,68,'"1229"','"Python"',3550,765,4315
'"1299"','"coi-services"','"43"',243,221,464,'"860"','"Python"',6896,1868,8764
'"1301"','"heroku"','"32"',67,18,85,'"1814"','"Ruby"',2423,308,2731
'"1334"','"rails"','"37"',697,398,1095,'"2155"','"Ruby"',35027,8997,44024
'"1404"','"quadbase"','"11"',1,0,1,'"923"','"Ruby"',546,89,635
'"1523"','"marketplace-tests"','"40"',29,30,59,'"748"','"Python"',567,395,962
'"1528"','"spree-guides"','"51"',150,3,153,'"1295"','"Ruby"',1621,123,1744
'"1536"','"barclamp-nova_dashboard"','"18"',0,0,0,'"891"','"Ruby"',31,46,77
'"1577"','"barclamp-dns"','"18"',0,0,0,'"910"','"Ruby"',45,32,77
'"1580"','"barclamp-ipmi"','"18"',0,0,0,'"910"','"Ruby"',33,26,59
'"1581"','"barclamp-keystone"','"18"',0,0,0,'"896"','"Ruby"',24,52,76
'"1593"','"barclamp-ganglia"','"18"',0,0,0,'"910"','"Ruby"',35,26,61
'"1599"','"barclamp-swift"','"18"',0,0,0,'"910"','"Ruby"',26,40,66
'"1624"','"barclamp-glance"','"18"',0,0,0,'"910"','"Ruby"',26,58,84
'"1636"','"barclamp-ntp"','"18"',0,0,0,'"910"','"Ruby"',13,17,30
'"1642"','"barclamp-provisioner"','"18"',0,0,0,'"910"','"Ruby"',190,89,279
'"1678"','"cucumber"','"33"',57,18,75,'"2149"','"Ruby"',1611,289,1900
'"1799"','"Theano"','"10"',58,54,112,'"939"','"Python"',10297,1397,11694
'"1883"','"transfair"','"11"',0,0,0,'"588"','"Ruby"',221,2,223
'"1957"','"CraftBukkit"','"14"',15,34,49,'"1158"','"Java"',2133,1327,3460
'"1958"','"infinispan"','"29"',94,93,187,'"1218"','"Java"',6567,2414,8981
'"1965"','"docs"','"30"',318,115,433,'"1079"','"Python"',2318,1091,3409
'"1993"','"barclamp-openstack"','"16"',0,0,0,'"867"','"Ruby"',38,19,57
'"2010"','"barclamp-deployer"','"18"',0,0,0,'"910"','"Ruby"',170,82,252
'"2014"','"barclamp-mysql"','"18"',0,0,0,'"896"','"Ruby"',15,25,40
'"2017"','"barclamp-nova"','"18"',0,0,0,'"910"','"Python"',90,100,190
'"2032"','"barclamp-test"','"18"',0,0,0,'"910"','"Ruby"',38,16,54
'"2033"','"barclamp-network"','"18"',0,0,0,'"910"','"Ruby"',151,109,260
'"2093"','"fog"','"53"',155,127,282,'"1753"','"Ruby"',5014,1901,6915
'"2202"','"rauth"','"29"',1,2,3,'"734"','"Python"',277,76,353
'"2244"','"factory_girl"','"81"',17,10,27,'"2102"','"Ruby"',293,181,474
'"2247"','"rpm"','"13"',91,5,96,'"1952"','"Ruby"',4025,146,4171
'"2281"','"gradle"','"15"',668,19,687,'"1639"','"Java"',9161,253,9414
'"2306"','"barclamp-logging"','"18"',0,0,0,'"910"','"Ruby"',44,31,75
'"2309"','"DemoSite"','"14"',68,4,72,'"695"','"Java"',907,21,928
'"2315"','"Spout"','"11"',0,0,0,'"1040"','"Java"',1807,526,2333
'"2532"','"openmrs-module-htmlformentry"','"23"',10,6,16,'"857"','"Java"',243,57,300
'"2539"','"multiple-scms-plugin"','"311"',0,0,0,'"1101"','"Java"',35,5,40
'"2634"','"ruby_koans"','"32"',0,0,0,'"1865"','"Ruby"',96,50,146
'"2713"','"rhc"','"12"',34,22,56,'"961"','"Ruby"',758,543,1301
'"2719"','"sidekiq"','"13"',108,38,146,'"780"','"Ruby"',1028,500,1528
'"2812"','"diaspora"','"28"',142,63,205,'"1268"','"Ruby"',11203,1668,12871
'"2863"','"ion-definitions"','"44"',69,50,119,'"863"','"Java"',1614,511,2125
'"2888"','"fluentd"','"11"',50,17,67,'"991"','"Ruby"',511,162,673
'"2919"','"chef-php-extra"','"57"',1,2,3,'"603"','"Ruby"',68,29,97
'"2938"','"Razor"','"170"',0,0,0,'"773"','"Ruby"',1072,231,1303
'"2980"','"homesick"','"14"',8,8,16,'"1463"','"Ruby"',95,49,144
'"3083"','"floodlight"','"41"',3,4,7,'"841"','"Java"',844,416,1260
'"3298"','"barclamp-ApacheHadoop"','"18"',0,0,0,'"713"','"Ruby"',13,10,23
'"3299"','"barclamp-clouderamanager"','"18"',0,0,0,'"724"','"Ruby"',69,53,122
'"3328"','"barclamp-pig"','"18"',0,0,0,'"836"','"Ruby"',12,19,31
'"3329"','"windows"','"29"',10,2,12,'"722"','"Ruby"',130,73,203
'"3334"','"barclamp-hive"','"18"',0,0,0,'"836"','"Ruby"',12,20,32
'"3339"','"barclamp-hadoop"','"18"',0,0,0,'"836"','"Ruby"',8,14,22
'"3348"','"barclamp-sqoop"','"18"',0,0,0,'"836"','"Ruby"',12,20,32
'"3361"','"barclamp-zookeeper"','"18"',0,0,0,'"836"','"Ruby"',7,11,18
'"3450"','"big-data-plugin"','"52"',19,21,40,'"643"','"Java"',483,204,687
'"3465"','"servo"','"104"',22,11,33,'"811"','"Java"',221,168,389
'"3479"','"github-services"','"33"',37,30,67,'"1392"','"Ruby"',874,591,1465
'"3594"','"jbpm"','"55"',115,8,123,'"1261"','"Java"',1599,193,1792
'"3671"','"sorcery"','"12"',5,10,15,'"1132"','"Ruby"',154,187,341
'"3680"','"ceylon-lang.org"','"16"',44,4,48,'"960"','"Ruby"',1093,78,1171
'"3721"','"ceylon-spec"','"16"',64,2,66,'"1137"','"Java"',2162,62,2224
'"3732"','"ceylon-ide-eclipse"','"15"',460,0,460,'"945"','"Java"',3221,34,3255
'"3796"','"energy3d"','"10"',88,0,88,'"594"','"Java"',654,0,654
'"3828"','"phonelabservices"','"10"',0,0,0,'"813"','"Java"',83,0,83
'"3857"','"c24-spring"','"15"',0,0,0,'"966"','"Java"',210,0,210
'"3918"','"mrjob"','"13"',15,15,30,'"1240"','"Python"',997,388,1385
'"3923"','"docs"','"18"',586,119,705,'"895"','"Python"',5158,1628,6786
'"3932"','"mysql"','"34"',17,21,38,'"722"','"Ruby"',263,170,433
'"3944"','"WeasyPrint"','"15"',12,3,15,'"940"','"Python"',494,31,525
'"4023"','"ralph"','"10"',37,40,77,'"658"','"Python"',3538,725,4263
'"4068"','"jruby"','"22"',595,56,651,'"1796"','"Ruby"',12885,609,13494
'"4092"','"stackmob-java-client-sdk"','"22"',0,0,0,'"883"','"Java"',560,24,584
'"4095"','"elasticsearch"','"10"',1348,275,1623,'"1487"','"Java"',8985,1221,10206
'"4114"','"CocoaPods"','"48"',44,18,62,'"935"','"Ruby"',1940,271,2211
'"4179"','"cadmium"','"40"',15,1,16,'"680"','"Java"',716,71,787
'"4327"','"studio3-php"','"18"',5,0,5,'"1403"','"Java"',886,3,889
'"4333"','"The-Daily-Show.bundle"','"15"',2,1,3,'"1316"','"Python"',33,8,41
'"4352"','"The-Colbert-Report.bundle"','"15"',2,0,2,'"1316"','"Python"',61,7,68
'"4435"','"reactor"','"11"',14,0,14,'"913"','"Python"',264,0,264
'"4451"','"studio3-ruby"','"16"',4,0,4,'"1186"','"Java"',225,0,225
'"4477"','"cookbooks"','"79"',0,0,0,'"1873"','"Ruby"',296,401,697
'"4508"','"oauth2app"','"13"',1,0,1,'"989"','"Python"',61,35,96
'"4563"','"voldemort"','"18"',37,6,43,'"1740"','"Java"',463,87,550
'"4573"','"ironfan"','"16"',17,6,23,'"1392"','"Ruby"',579,105,684
'"4660"','"twitter-cldr-rb"','"226"',42,0,42,'"740"','"Ruby"',474,80,554
'"4751"','"Catroid"','"166"',466,29,495,'"646"','"Java"',14499,502,15001
'"4765"','"bigbluebutton"','"15"',102,11,113,'"1381"','"Java"',5024,308,5332
'"4779"','"openstates"','"12"',315,6,321,'"1834"','"Python"',8141,112,8253
'"4798"','"apache2"','"29"',16,8,24,'"722"','"Ruby"',149,118,267
'"4892"','"run-crowbar-on-sepia"','"28"',0,0,0,'"612"','"Python"',25,2,27
'"4927"','"application"','"12"',7,4,11,'"771"','"Java"',1002,125,1127
'"5016"','"activeresource"','"28"',9,4,13,'"723"','"Ruby"',54,75,129
'"5106"','"CBS-Sports.bundle"','"15"',0,0,0,'"1316"','"Python"',35,4,39
'"5125"','"glance"','"21"',8,9,17,'"702"','"Python"',258,183,441
'"5138"','"keystone"','"21"',4,4,8,'"702"','"Ruby"',265,161,426
'"5184"','"django-haystack"','"13"',10,24,34,'"1862"','"Python"',429,297,726
'"5210"','"okhttp"','"19"',421,155,576,'"591"','"Java"',1131,427,1558
'"5245"','"twitter"','"11"',172,9,181,'"2212"','"Ruby"',1396,170,1566
'"5247"','"MIT-Mobile-for-Android"','"10"',30,0,30,'"1331"','"Java"',507,0,507
'"5323"','"responders"','"24"',2,1,3,'"1555"','"Ruby"',126,33,159
'"5378"','"Bukkit"','"15"',13,43,56,'"1159"','"Java"',588,1024,1612
'"5400"','"pyon"','"44"',68,41,109,'"939"','"Python"',1863,477,2340
'"5444"','"usergrid-stack"','"36"',1,0,1,'"885"','"Java"',2952,232,3184
'"5465"','"iSENSE-Hardware"','"11"',61,53,114,'"811"','"Java"',1159,825,1984
'"5516"','"geoserver"','"30"',176,94,270,'"847"','"Java"',2543,527,3070
'"5520"','"Specs"','"440"',2354,2087,4441,'"907"','"Ruby"',14220,8498,22718
'"5556"','"SynapseWebClient"','"16"',94,88,182,'"664"','"Java"',2779,850,3629
'"5591"','"facter"','"195"',143,59,202,'"1269"','"Ruby"',1073,649,1722
'"5626"','"beets"','"19"',205,31,236,'"1305"','"Python"',2129,234,2363
'"5640"','"Arduino"','"11"',107,35,142,'"1266"','"Java"',1924,316,2240
'"5684"','"galaxy-client"','"42"',0,0,0,'"878"','"Ruby"',430,107,537
'"6026"','"gitlabhq"','"17"',720,170,890,'"886"','"Ruby"',5856,2087,7943
'"6087"','"barkeep"','"21"',0,2,2,'"917"','"Ruby"',644,65,709
'"6129"','"testlink-plugin"','"301"',0,0,0,'"1179"','"Java"',75,15,90
'"6171"','"la-clojure"','"13"',4,2,6,'"941"','"Java"',308,28,336
'"6186"','"statshtable"','"54"',0,0,0,'"772"','"Java"',45,11,56
'"6189"','"bidpom"','"50"',0,0,0,'"764"','"Python"',118,42,160
'"6413"','"commons"','"338"',259,29,288,'"1101"','"Java"',497,177,674
'"6468"','"modeshape"','"13"',21,43,64,'"1149"','"Java"',3251,1068,4319
'"6553"','"gunicorn"','"29"',0,0,0,'"722"','"Ruby"',28,7,35
'"6570"','"hiera"','"178"',25,11,36,'"1006"','"Ruby"',243,171,414
'"6584"','"liquid"','"271"',73,12,85,'"2128"','"Ruby"',445,157,602
'"6606"','"django-tastypie"','"14"',9,13,22,'"1438"','"Python"',555,561,1116
'"6648"','"nexus_cli"','"12"',1,1,2,'"630"','"Ruby"',353,72,425
'"6923"','"rightscale_cookbooks"','"151"',42,3,45,'"679"','"Ruby"',1655,152,1807
'"6966"','"CoAnSys"','"12"',26,22,48,'"594"','"Java"',1096,243,1339
'"6994"','"gherkin"','"33"',16,8,24,'"1647"','"Ruby"',1370,114,1484
'"7058"','"pry"','"14"',215,23,238,'"1185"','"Ruby"',1384,245,1629
'"7148"','"curator"','"115"',0,0,0,'"966"','"Java"',354,138,492
'"7233"','"sunspot"','"14"',7,12,19,'"1970"','"Ruby"',881,270,1151
'"7347"','"Markus"','"89"',22,27,49,'"1257"','"Ruby"',1346,721,2067
'"7511"','"Synapse-Repository-Services"','"16"',161,148,309,'"653"','"Java"',3076,1111,4187
'"7537"','"kivy"','"11"',277,93,370,'"1219"','"Python"',3637,814,4451
'"7550"','"akanda"','"10"',0,0,0,'"635"','"Python"',911,60,971
'"7559"','"enaml"','"76"',0,0,0,'"944"','"Python"',3443,184,3627
'"7575"','"dotcloud-cli"','"13"',3,2,5,'"918"','"Python"',281,26,307
'"7588"','"OpenMDAO-Framework"','"15"',103,98,201,'"983"','"Python"',5653,976,6629
'"7608"','"reddit"','"15"',222,22,244,'"2087"','"Python"',2817,460,3277
'"7640"','"konacha"','"21"',5,2,7,'"753"','"Ruby"',188,67,255
'"7698"','"do"','"11"',9,2,11,'"1865"','"Ruby"',240,28,268
'"7699"','"moztrap"','"11"',4,5,9,'"827"','"Python"',1554,54,1608
'"7728"','"plexus-utils"','"30"',1,1,2,'"1360"','"Java"',152,10,162
'"7894"','"money"','"65"',20,11,31,'"1952"','"Ruby"',576,182,758
'"7933"','"facebook-android-sdk"','"46"',1,3,4,'"1396"','"Java"',265,85,350
'"7954"','"components-ness-jackson"','"15"',3,1,4,'"667"','"Java"',75,13,88
'"7979"','"omniauth-google"','"12"',0,0,0,'"804"','"Ruby"',2,3,5
'"8006"','"diazo"','"235"',0,0,0,'"893"','"Python"',216,19,235
'"8107"','"fcc_political_ads"','"18"',1,0,1,'"685"','"Python"',619,0,619
'"8127"','"matplotlib"','"20"',86,99,185,'"1111"','"Python"',8291,1687,9978
'"8131"','"jclouds"','"24"',132,38,170,'"1500"','"Java"',7905,1431,9336
'"8381"','"nuxeo-core"','"22"',101,0,101,'"812"','"Java"',1151,7,1158
'"8466"','"puppetlabs-rabbitmq"','"62"',3,6,9,'"1080"','"Ruby"',83,136,219
'"8612"','"components"','"11"',14,17,31,'"1184"','"Java"',419,650,1069
'"8676"','"wukong"','"11"',2,1,3,'"1865"','"Ruby"',1043,7,1050
'"8703"','"brigade"','"104"',32,4,36,'"762"','"Ruby"',795,191,986
'"8778"','"red-start"','"28"',0,0,0,'"707"','"Python"',62,4,66
'"9095"','"hdo-site"','"24"',136,3,139,'"698"','"Ruby"',2205,98,2303
'"9126"','"rackspace-monitoring"','"136"',11,5,16,'"853"','"Python"',160,36,196
'"9174"','"mongodb-engine"','"13"',0,0,0,'"1252"','"Python"',132,52,184
'"9241"','"django-oscar"','"57"',307,67,374,'"1184"','"Python"',3399,751,4150
'"9354"','"fred-staging"','"14"',20,7,27,'"1776"','"Java"',16946,200,17146
'"9391"','"oss-docs"','"11"',0,0,0,'"696"','"Ruby"',145,9,154
'"9427"','"spree"','"12"',508,121,629,'"2187"','"Ruby"',13807,2384,16191
'"9531"','"openmrs-module-hl7query"','"33"',0,0,0,'"588"','"Java"',158,66,224
'"9585"','"sympy-bot"','"17"',0,0,0,'"1043"','"Python"',228,80,308
'"9615"','"core"','"11"',418,37,455,'"1046"','"Java"',3605,398,4003
'"9774"','"podio-rb"','"12"',13,1,14,'"1218"','"Ruby"',516,7,523
'"9793"','"sympy"','"21"',137,164,301,'"1406"','"Python"',13428,2789,16217
'"9807"','"social"','"17"',18,21,39,'"701"','"Java"',2857,283,3140
'"9819"','"pycon"','"10"',0,0,0,'"1354"','"Python"',378,22,400
'"9840"','"mongo-java-driver"','"12"',168,10,178,'"1876"','"Java"',1733,172,1905
'"10083"','"platform"','"16"',24,25,49,'"700"','"Java"',8898,458,9356
'"10182"','"exogtn"','"15"',8,4,12,'"1182"','"Java"',1487,141,1628
'"10252"','"commcare-hq"','"20"',3272,507,3779,'"1701"','"Python"',18658,2712,21370
'"10269"','"eucalyptus"','"13"',264,2,266,'"1017"','"Java"',12528,44,12572
'"10384"','"ecms"','"17"',40,43,83,'"700"','"Java"',4846,614,5460
'"10412"','"omniauth"','"14"',20,2,22,'"1437"','"Ruby"',280,285,565
'"10617"','"perl"','"26"',0,0,0,'"722"','"Ruby"',41,14,55
'"10646"','"chef-client"','"31"',35,12,47,'"722"','"Ruby"',241,153,394
'"10657"','"head"','"18"',0,0,0,'"1121"','"Java"',9018,341,9359
'"10667"','"flask-lastuser"','"10"',13,0,13,'"1021"','"Python"',93,5,98
'"10735"','"python-oauth2"','"22"',0,0,0,'"1597"','"Python"',50,64,114
'"10773"','"iis"','"26"',3,2,5,'"722"','"Ruby"',89,48,137
'"10882"','"projectmonitor"','"19"',33,2,35,'"689"','"Ruby"',810,29,839
'"10916"','"tubaina"','"16"',0,0,0,'"1745"','"Java"',354,7,361
'"11021"','"VintageEx"','"47"',0,1,1,'"856"','"Python"',123,13,136
'"11108"','"Synapse-Stack-Builder"','"13"',6,7,13,'"597"','"Java"',123,83,206
'"11124"','"acts-as-taggable-on"','"13"',9,15,24,'"2176"','"Ruby"',144,152,296
'"11321"','"travis-ci.github.com"','"47"',11,10,21,'"992"','"Ruby"',1158,387,1545
'"11326"','"janrain-backplane-2"','"70"',1,0,1,'"812"','"Java"',683,53,736
'"11379"','"smart-answers"','"118"',298,85,383,'"862"','"Ruby"',4747,747,5494
'"11525"','"kong"','"17"',4,3,7,'"665"','"Ruby"',56,44,100
'"11602"','"travis-cookbooks"','"21"',43,11,54,'"1003"','"Ruby"',1235,138,1373
'"11630"','"vcap"','"118"',0,0,0,'"1059"','"Ruby"',896,130,1026
'"11638"','"readthedocs.org"','"11"',243,46,289,'"1298"','"Python"',2755,250,3005
'"11644"','"rabbitmq"','"26"',19,10,29,'"722"','"Ruby"',138,106,244
'"11660"','"sass-rails"','"32"',3,4,7,'"1017"','"Ruby"',86,45,131
'"11959"','"strong_parameters"','"25"',7,4,11,'"723"','"Ruby"',92,113,205
'"12031"','"rubinius"','"108"',161,28,189,'"2245"','"Ruby"',10355,1000,11355
'"12106"','"chef-cookbooks"','"39"',92,49,141,'"860"','"Ruby"',5137,447,5584
'"12132"','"rails-i18n"','"10"',20,21,41,'"2044"','"Ruby"',246,328,574
'"12258"','"devise"','"27"',31,40,71,'"1632"','"Ruby"',1958,604,2562
'"12333"','"drools"','"39"',253,17,270,'"1112"','"Java"',9341,318,9659
'"12383"','"webos"','"13"',4,0,4,'"1080"','"Java"',265,22,287
'"12392"','"collective.developermanual"','"409"',53,16,69,'"972"','"Python"',2305,174,2479
'"12455"','"k-9"','"19"',49,17,66,'"1126"','"Java"',3679,457,4136
'"12631"','"etsy"','"12"',2,2,4,'"1785"','"Ruby"',169,43,212
'"12647"','"rhostudio"','"20"',1,0,1,'"1092"','"Java"',349,2,351
'"12666"','"qless-py"','"45"',2,0,2,'"727"','"Python"',148,6,154
'"12722"','"cs"','"14"',6,1,7,'"700"','"Java"',5694,101,5795
'"12747"','"active_admin"','"10"',87,49,136,'"1421"','"Ruby"',1466,1004,2470
'"12841"','"shinken"','"23"',145,31,176,'"1199"','"Python"',4156,412,4568
'"12885"','"rails_admin"','"12"',40,12,52,'"1313"','"Ruby"',1915,599,2514
'"13001"','"Osmand"','"10"',109,12,121,'"1146"','"Java"',6890,542,7432
'"13021"','"suspenders"','"80"',101,31,132,'"1392"','"Ruby"',593,167,760
'"13116"','"WMCore"','"24"',55,53,108,'"906"','"Python"',8725,627,9352
'"13296"','"zsh-completions"','"18"',2,5,7,'"960"','"Python"',199,125,324
'"13383"','"killbill"','"16"',0,0,0,'"860"','"Java"',502,0,502
'"13573"','"bnd"','"10"',211,12,223,'"1424"','"Java"',1963,113,2076
'"13665"','"dm-core"','"10"',0,0,0,'"1865"','"Ruby"',83,53,136
'"13718"','"vraptor"','"21"',21,11,32,'"1813"','"Java"',3503,168,3671
'"13860"','"ruby"','"21"',661,58,719,'"1468"','"Ruby"',32793,554,33347
'"13915"','"elephant-bird"','"10"',5,6,11,'"1442"','"Java"',418,280,698
'"13998"','"storm-contrib"','"13"',0,1,1,'"847"','"Java"',80,22,102
'"14080"','"cosm-rb"','"14"',0,0,0,'"654"','"Ruby"',284,35,319
'"14184"','"Affiliates-Tests"','"28"',0,0,0,'"881"','"Python"',41,36,77
'"14363"','"nexus"','"39"',2,2,4,'"1057"','"Java"',10985,863,11848
'"14398"','"guvnor"','"53"',70,2,72,'"1119"','"Java"',5482,110,5592
'"14642"','"DIRAC"','"24"',137,64,201,'"1065"','"Python"',13927,1279,15206
'"14901"','"autotest"','"25"',31,13,44,'"899"','"Python"',8299,499,8798
'"14915"','"travis-ci"','"41"',11,2,13,'"1102"','"Ruby"',3732,209,3941
'"15058"','"gitscm-next"','"11"',0,0,0,'"728"','"Ruby"',313,137,450
'"15189"','"sslyze"','"23"',0,0,0,'"606"','"Python"',198,20,218
'"15299"','"travis-boxes"','"41"',0,0,0,'"887"','"Ruby"',197,13,210
'"15441"','"badgeville-ruby"','"10"',3,0,3,'"806"','"Ruby"',299,6,305
'"15664"','"django-timepiece"','"10"',20,1,21,'"885"','"Python"',2462,302,2764
'"15806"','"core"','"21"',102,42,144,'"1309"','"Java"',4470,489,4959
'"15841"','"simple_form"','"27"',6,6,12,'"1529"','"Ruby"',558,320,878
'"15883"','"candidator"','"21"',6,1,7,'"848"','"Python"',1110,147,1257
'"15985"','"oq-engine"','"30"',311,33,344,'"1347"','"Python"',5334,1244,6578
'"16015"','"grails-data-mapping"','"77"',0,0,0,'"1108"','"Java"',522,92,614
'"16060"','"guard-jasmine"','"40"',6,0,6,'"912"','"Ruby"',258,58,316
'"16166"','"guard"','"12"',39,16,55,'"1312"','"Ruby"',657,214,871
'"16282"','"nucore-open"','"27"',149,19,168,'"1098"','"Ruby"',1424,102,1526
'"16392"','"nuxeo-common"','"22"',7,0,7,'"812"','"Java"',376,1,377
'"16401"','"nuxeo-webengine"','"22"',11,0,11,'"812"','"Java"',115,2,117
'"16451"','"NME.bundle"','"15"',1,0,1,'"1316"','"Python"',24,3,27
'"16640"','"mozservices"','"11"',20,1,21,'"869"','"Python"',198,22,220
'"16719"','"basex"','"14"',130,18,148,'"1114"','"Java"',4081,332,4413
'"16912"','"Praktikum"','"22"',0,0,0,'"585"','"Java"',670,0,670
'"16948"','"BroadleafCommerce"','"12"',458,3,461,'"818"','"Java"',3999,84,4083
'"16968"','"rails3-jquery-autocomplete"','"33"',6,4,10,'"1329"','"Ruby"',109,91,200
'"17032"','"Silverpeas-Core"','"11"',121,34,155,'"1130"','"Java"',3318,480,3798
'"17042"','"Silverpeas-Components"','"11"',42,16,58,'"1130"','"Java"',1680,290,1970
'"17196"','"riak-python-client"','"15"',22,5,27,'"1420"','"Python"',511,203,714
'"17307"','"studio3-rcp"','"18"',19,0,19,'"1603"','"Java"',234,3,237
'"17345"','"tools"','"11"',13,10,23,'"921"','"Java"',233,370,603
'"17473"','"Products.CMFPlone"','"234"',151,10,161,'"893"','"Python"',1708,93,1801
'"17589"','"shoulda-matchers"','"84"',209,28,237,'"1177"','"Ruby"',881,257,1138
'"17630"','"puppetlabs-cloud_provisioner"','"141"',3,2,5,'"1085"','"Ruby"',129,133,262
'"17635"','"rSENSE"','"10"',116,124,240,'"582"','"Ruby"',981,907,1888
'"17735"','"fat_free_crm"','"11"',74,7,81,'"1927"','"Ruby"',3299,143,3442
'"17919"','"spree_i18n"','"34"',62,29,91,'"1278"','"Ruby"',527,288,815
'"18070"','"opdemand-cli"','"12"',0,0,0,'"787"','"Python"',197,1,198
'"18116"','"imglib"','"18"',0,0,0,'"811"','"Java"',1777,22,1799
'"18159"','"warnings-plugin"','"301"',20,2,22,'"1178"','"Java"',366,34,400
'"18170"','"shoes4"','"19"',99,13,112,'"651"','"Ruby"',1127,194,1321
'"18217"','"zamboni"','"30"',514,233,747,'"1595"','"Python"',10106,1802,11908
'"18260"','"adhearsion"','"10"',69,12,81,'"1409"','"Ruby"',1974,151,2125
'"18353"','"Pydev"','"16"',5,1,6,'"1659"','"Java"',362,48,410
'"18460"','"sonar-examples"','"10"',8,1,9,'"889"','"Python"',247,7,254
'"18578"','"right_aws"','"99"',0,0,0,'"1723"','"Ruby"',86,62,148
'"18716"','"rubygems"','"13"',137,28,165,'"1420"','"Ruby"',5255,328,5583
'"18742"','"MacRuby"','"10"',0,0,0,'"1243"','"Ruby"',368,68,436
'"18790"','"git-hooks"','"10"',0,0,0,'"582"','"Ruby"',24,0,24
'"19050"','"victorykit"','"10"',6,2,8,'"689"','"Ruby"',1490,17,1507
'"19070"','"textizen"','"74"',0,0,0,'"701"','"Ruby"',451,10,461
'"19117"','"virtualenv"','"12"',46,15,61,'"1096"','"Python"',367,223,590
'"19220"','"cornice"','"14"',1,3,4,'"876"','"Python"',197,123,320
'"19428"','"mne-python"','"19"',96,70,166,'"1133"','"Python"',2359,796,3155
'"19443"','"marionette-collective"','"170"',39,29,68,'"1232"','"Ruby"',890,169,1059
'"19559"','"cismap-commons"','"11"',66,0,66,'"679"','"Java"',791,0,791
'"19616"','"shoulda"','"72"',0,0,0,'"2152"','"Ruby"',253,23,276
'"19746"','"jenkins.rb"','"305"',0,0,0,'"1462"','"Ruby"',116,58,174
'"19844"','"publisher"','"113"',81,19,100,'"976"','"Ruby"',2547,166,2713
'"19849"','"mct"','"12"',8,7,15,'"674"','"Java"',401,84,485
'"20077"','"chef-apps"','"14"',0,0,0,'"601"','"Ruby"',14,0,14
'"20182"','"testrunner"','"41"',5,0,5,'"1212"','"Python"',445,1,446
'"20225"','"social_stream"','"10"',21,0,21,'"1259"','"Ruby"',1405,36,1441
'"20429"','"paperclip"','"83"',97,28,125,'"2156"','"Ruby"',724,436,1160
'"20500"','"mcom-tests"','"40"',8,8,16,'"1057"','"Python"',346,240,586
'"20700"','"text-to-squares"','"10"',0,0,0,'"583"','"Ruby"',182,67,249
'"20768"','"fauxhai"','"20"',18,19,37,'"606"','"Ruby"',99,61,160
'"20786"','"bosh"','"112"',473,30,503,'"703"','"Ruby"',6988,363,7351
'"20796"','"hazelcast"','"15"',443,282,725,'"715"','"Java"',5419,946,6365
'"20849"','"blacklight"','"12"',338,93,431,'"1588"','"Ruby"',2115,222,2337
'"20984"','"newrelic_api"','"82"',0,0,0,'"1155"','"Ruby"',75,7,82
'"21093"','"activerecord-jdbc-adapter"','"28"',34,6,40,'"2172"','"Ruby"',1748,236,1984
'"21168"','"chef-repo"','"49"',0,0,0,'"1876"','"Ruby"',60,18,78
'"21276"','"prawn"','"17"',140,22,162,'"2162"','"Ruby"',1949,170,2119
'"21417"','"voto-como-vamos"','"25"',0,0,0,'"636"','"Ruby"',511,9,520
'"21435"','"org.ops4j.pax.web"','"64"',32,4,36,'"1266"','"Java"',819,19,838
'"21468"','"git_immersion"','"29"',0,0,0,'"1360"','"Ruby"',106,3,109
'"21530"','"spree_active_shipping"','"34"',6,2,8,'"1178"','"Ruby"',211,120,331
'"21597"','"geotools"','"27"',139,47,186,'"847"','"Java"',2876,385,3261
'"21703"','"right_link"','"124"',267,48,315,'"1693"','"Ruby"',2965,335,3300
'"21750"','"dipy"','"20"',16,17,33,'"1489"','"Python"',911,268,1179
'"21799"','"Shaastra-2013-Website"','"11"',0,0,0,'"665"','"Python"',1169,5,1174
'"21986"','"bluepill"','"26"',0,0,0,'"722"','"Ruby"',81,20,101
'"22016"','"build-essential"','"26"',2,0,2,'"722"','"Ruby"',68,26,94
'"22048"','"couchdb"','"29"',0,0,0,'"722"','"Ruby"',70,13,83
'"22056"','"daemontools"','"26"',1,1,2,'"722"','"Ruby"',20,7,27
'"22073"','"chef_handler"','"29"',5,0,5,'"722"','"Ruby"',16,12,28
'"22138"','"stapler"','"11"',11,1,12,'"1072"','"Java"',474,23,497
'"22189"','"ceylon-common"','"14"',2,0,2,'"694"','"Java"',247,4,251
'"22229"','"simple_form-bootstrap"','"11"',0,0,0,'"907"','"Ruby"',33,17,50
'"22419"','"magja"','"14"',0,0,0,'"855"','"Java"',301,3,304
'"22588"','"surveyor"','"10"',0,1,1,'"1868"','"Ruby"',666,105,771
'"22616"','"retrofit"','"15"',91,29,120,'"1277"','"Java"',584,264,848
'"22652"','"has_scope"','"18"',0,1,1,'"1553"','"Ruby"',43,19,62
'"22668"','"Priam"','"103"',13,4,17,'"960"','"Java"',553,204,757
'"22811"','"ohai"','"76"',95,32,127,'"1876"','"Ruby"',1467,285,1752
'"22841"','"django-rest-framework"','"11"',86,78,164,'"1100"','"Python"',1945,844,2789
'"22964"','"config"','"21"',25,4,29,'"821"','"Java"',227,30,257
'"23032"','"asset_sync"','"16"',0,5,5,'"950"','"Ruby"',181,90,271
'"23043"','"astyanax"','"105"',19,16,35,'"967"','"Java"',360,181,541
'"23052"','"buildbot"','"12"',73,45,118,'"1339"','"Python"',2508,1084,3592
'"23280"','"nginx"','"31"',28,10,38,'"722"','"Ruby"',227,196,423
'"23440"','"zipwhip-api"','"11"',21,0,21,'"929"','"Java"',384,1,385
'"23593"','"radiant"','"16"',47,0,47,'"2085"','"Ruby"',433,60,493
'"23623"','"knife-ec2"','"75"',20,27,47,'"1095"','"Ruby"',228,188,416
'"23635"','"goliath"','"25"',3,4,7,'"1155"','"Ruby"',215,135,350
'"23710"','"nova"','"21"',16,21,37,'"702"','"Ruby"',360,358,718
'"23873"','"marketplace-loadtest"','"18"',0,0,0,'"583"','"Python"',29,0,29
'"23903"','"watirmark"','"10"',12,0,12,'"717"','"Ruby"',600,3,603
'"24177"','"Django-Socialauth"','"12"',0,0,0,'"1653"','"Python"',53,8,61
'"24397"','"linguist"','"37"',38,57,95,'"1032"','"Ruby"',867,688,1555
'"24423"','"puppetlabs-stdlib"','"171"',12,15,27,'"1017"','"Ruby"',328,226,554
'"24440"','"server-syncstorage"','"11"',54,2,56,'"764"','"Python"',374,6,380
'"24467"','"tarkin"','"17"',0,0,0,'"813"','"Python"',38,1,39
'"24575"','"services"','"12"',18,9,27,'"749"','"Java"',1881,143,2024
'"24664"','"marteau"','"11"',0,0,0,'"583"','"Python"',123,4,127
'"24741"','"playn"','"15"',34,2,36,'"930"','"Java"',790,17,807
'"24761"','"loomio"','"13"',0,0,0,'"849"','"Ruby"',3321,521,3842
'"24828"','"quickstarts"','"11"',8,10,18,'"1106"','"Java"',151,309,460
'"25055"','"build-buildbot-configs"','"11"',194,0,194,'"583"','"Python"',1567,0,1567
'"25097"','"plone.app.theming"','"235"',9,3,12,'"893"','"Python"',295,21,316
'"25139"','"react"','"15"',3,0,3,'"948"','"Java"',128,2,130
'"25156"','"govuk_content_models"','"91"',142,24,166,'"661"','"Ruby"',894,131,1025
'"25222"','"Pypeline"','"14"',27,0,27,'"644"','"Python"',555,0,555
'"25326"','"ckan"','"18"',122,31,153,'"847"','"Python"',12193,932,13125
'"25467"','"cloudify"','"14"',308,0,308,'"770"','"Java"',6119,94,6213
'"25590"','"mry"','"43"',7,2,9,'"709"','"Java"',604,153,757
'"25822"','"nltk"','"11"',50,36,86,'"1641"','"Python"',8361,264,8625
'"26287"','"collective.facets"','"256"',24,0,24,'"582"','"Python"',37,1,38
'"26423"','"CONNECT"','"29"',50,47,97,'"750"','"Java"',6632,687,7319
'"26428"','"contributing-code-app"','"15"',0,0,0,'"603"','"Ruby"',14,0,14
'"26591"','"hibernate-orm"','"18"',284,54,338,'"1249"','"Java"',4312,705,5017
'"26697"','"mcMMO"','"11"',358,6,364,'"791"','"Java"',4894,217,5111
'"26946"','"artifact-cookbook"','"13"',3,1,4,'"730"','"Ruby"',349,72,421
'"27140"','"Chef-Metasploit"','"42"',1,1,2,'"648"','"Ruby"',123,3,126
'"27142"','"pip"','"11"',105,86,191,'"1096"','"Python"',1596,617,2213
'"27329"','"pandas"','"11"',435,295,730,'"1290"','"Python"',7617,2133,9750
'"27412"','"stackmob-customcode-sdk"','"23"',0,0,0,'"908"','"Java"',217,12,229
'"27693"','"bourbon"','"82"',11,11,22,'"1048"','"Ruby"',433,161,594
'"27716"','"jcr"','"14"',15,4,19,'"700"','"Java"',3015,158,3173
'"27859"','"capybara-webkit"','"82"',5,7,12,'"1105"','"Ruby"',251,223,474
'"27868"','"jcr-services"','"10"',11,0,11,'"701"','"Java"',260,3,263
'"27886"','"WebDBM"','"14"',0,0,0,'"603"','"Ruby"',28,0,28
'"27986"','"django-browserid"','"32"',3,11,14,'"961"','"Python"',99,136,235
'"28021"','"wiki"','"10"',17,21,38,'"681"','"Java"',232,107,339
'"28030"','"forum"','"11"',14,12,26,'"667"','"Java"',240,74,314
'"28175"','"chaco"','"83"',58,7,65,'"1133"','"Python"',1209,128,1337
'"28270"','"epu"','"37"',0,0,0,'"1095"','"Python"',658,23,681
'"28304"','"django-extensions"','"11"',46,15,61,'"1811"','"Python"',439,250,689
'"28433"','"cronos.teilar.gr"','"16"',0,0,0,'"631"','"Python"',505,0,505
'"28467"','"gargoyle"','"11"',0,0,0,'"1176"','"Python"',161,44,205
'"28758"','"IndentGuides"','"48"',0,0,0,'"944"','"Python"',13,1,14
'"28802"','"srtracker"','"50"',1,1,2,'"588"','"Python"',140,19,159
'"28824"','"cloud_controller_ng"','"104"',331,21,352,'"623"','"Ruby"',2663,141,2804
'"28915"','"collective.weather"','"323"',0,0,0,'"594"','"Python"',188,14,202
'"29408"','"openmrs-module-xforms"','"11"',11,0,11,'"619"','"Java"',363,12,375
'"29465"','"SAPI"','"13"',912,89,1001,'"665"','"Ruby"',4735,249,4984
'"29536"','"we-can-do-it"','"14"',3,0,3,'"624"','"Ruby"',328,7,335
'"29576"','"thehackerati.com"','"15"',0,0,0,'"636"','"Python"',38,7,45
'"30178"','"zendesk_api_client_rb"','"100"',44,2,46,'"812"','"Ruby"',623,45,668
'"30200"','"membase-cli"','"37"',0,0,0,'"1372"','"Python"',333,0,333
'"30491"','"spree_gateway"','"13"',27,7,34,'"808"','"Ruby"',271,81,352
'"30633"','"barclamp-redhat-install"','"18"',0,0,0,'"910"','"Ruby"',66,1,67
'"30634"','"barclamp-ubuntu-install"','"18"',0,0,0,'"910"','"Ruby"',56,1,57
'"30965"','"hasjob"','"11"',21,2,23,'"1050"','"Python"',344,27,371
'"31149"','"ReplicatorG"','"62"',0,0,0,'"1606"','"Python"',1778,103,1881
'"31216"','"narya"','"16"',7,0,7,'"1064"','"Java"',343,0,343
'"31779"','"travis-build"','"42"',54,24,78,'"885"','"Ruby"',937,165,1102
'"31845"','"nuxeo-distribution"','"22"',120,1,121,'"812"','"Java"',1099,9,1108
'"31865"','"nuxeo-runtime"','"22"',23,0,23,'"812"','"Java"',567,0,567
'"31961"','"nuxeo-activity"','"22"',7,0,7,'"720"','"Java"',88,1,89
'"31975"','"nuxeo-quota"','"22"',37,0,37,'"801"','"Java"',238,1,239
'"31995"','"nuxeo-social-collaboration"','"22"',15,0,15,'"1129"','"Java"',779,20,799
'"31996"','"nuxeo-user-center"','"22"',15,0,15,'"812"','"Java"',213,0,213
'"32076"','"oftest"','"34"',16,16,32,'"785"','"Python"',391,102,493
'"32709"','"xunit-plugin"','"301"',20,1,21,'"1178"','"Java"',440,16,456
'"33064"','"cloudera-cookbook"','"15"',0,0,0,'"762"','"Ruby"',157,5,162
'"33145"','"clearance"','"80"',43,14,57,'"1989"','"Ruby"',661,161,822
'"33666"','"wakame-vdc"','"16"',33,3,36,'"1422"','"Ruby"',7290,289,7579
'"33842"','"redmine-custom"','"12"',0,0,0,'"924"','"Ruby"',289,0,289
'"33858"','"ceylon.language"','"14"',147,5,152,'"884"','"Java"',2063,33,2096
'"33958"','"pyne"','"20"',60,63,123,'"1041"','"Python"',1006,152,1158
'"34268"','"cucumber-rails"','"29"',8,1,9,'"1578"','"Ruby"',223,98,321
'"34279"','"salt-cloud"','"15"',1,1,2,'"676"','"Python"',979,568,1547
'"34494"','"xrono"','"14"',0,0,0,'"1158"','"Ruby"',359,21,380
'"34627"','"Denizen"','"14"',129,72,201,'"732"','"Java"',2964,231,3195
'"34756"','"server-main"','"10"',6,0,6,'"811"','"Java"',165,22,187
'"34820"','"dc21"','"25"',46,0,46,'"780"','"Ruby"',816,0,816
'"34858"','"conferences"','"29"',0,0,0,'"700"','"Ruby"',212,5,217
'"34884"','"slave_pools"','"26"',14,2,16,'"758"','"Ruby"',149,4,153
'"35020"','"twitter-connector"','"97"',2,0,2,'"1154"','"Java"',328,3,331
'"35135"','"monospace-rails"','"14"',0,0,0,'"916"','"Ruby"',49,3,52
'"35311"','"puppetlabs_spec_helper"','"74"',3,7,10,'"805"','"Ruby"',49,52,101
'"35349"','"biceps"','"21"',12,1,13,'"888"','"Ruby"',71,4,75
'"35374"','"mtrack"','"10"',4,0,4,'"979"','"Python"',807,2,809
'"35378"','"sensu-community-plugins"','"15"',111,76,187,'"812"','"Ruby"',514,464,978
'"35649"','"gatein-portal"','"19"',49,44,93,'"721"','"Java"',4187,798,4985
'"35704"','"blueprints"','"14"',21,3,24,'"1487"','"Java"',1366,137,1503
'"35728"','"vcap-tests"','"14"',0,1,1,'"1059"','"Ruby"',330,12,342
'"35737"','"mailboxer"','"10"',0,2,2,'"1095"','"Ruby"',138,81,219
'"35770"','"rubygems.org"','"33"',53,10,63,'"1862"','"Ruby"',1141,232,1373
'"35804"','"puppet-dashboard"','"128"',0,0,0,'"1329"','"Ruby"',294,252,546
'"35846"','"kotlin"','"20"',2237,59,2296,'"752"','"Java"',18181,395,18576
'"36005"','"airbrake"','"19"',2,3,5,'"925"','"Ruby"',487,113,600
'"36089"','"heroku-eclipse-plugin"','"10"',0,0,0,'"694"','"Java"',375,3,378
'"36383"','"ananya-kilkari"','"49"',7,0,7,'"637"','"Java"',569,0,569
'"36570"','"avalon"','"10"',0,0,0,'"598"','"Python"',6,0,6
'"37105"','"ananya-care"','"54"',13,0,13,'"709"','"Java"',123,0,123
'"37124"','"admaster.github.com"','"20"',29,0,29,'"682"','"Ruby"',452,0,452
'"37321"','"exceptional"','"12"',0,0,0,'"2086"','"Ruby"',29,19,48
'"37382"','"ironmine"','"13"',0,0,0,'"1192"','"Ruby"',2538,2,2540
'"37553"','"cloudfoundry-env"','"15"',0,0,0,'"730"','"Ruby"',8,1,9
'"37628"','"pry-developer_tools"','"12"',0,0,0,'"780"','"Ruby"',19,2,21
'"37843"','"DSpace"','"26"',84,60,144,'"720"','"Java"',4835,493,5328
'"37853"','"motech-whp"','"57"',0,0,0,'"700"','"Java"',1074,0,1074
'"37888"','"amara-dev-blog"','"12"',0,0,0,'"629"','"Python"',22,0,22
'"38552"','"cap-strap"','"26"',0,0,0,'"687"','"Ruby"',83,0,83
'"38683"','"sonar-openid"','"14"',0,1,1,'"657"','"Java"',33,1,34
'"38823"','"sensu"','"15"',8,7,15,'"969"','"Ruby"',1097,560,1657
'"38896"','"logistics"','"28"',39,8,47,'"1123"','"Python"',3099,122,3221
'"39201"','"motech-contrib"','"65"',1,0,1,'"707"','"Java"',522,0,522
'"39421"','"motech-whp-reports"','"57"',0,0,0,'"596"','"Java"',263,0,263
'"39781"','"resty"','"39"',0,0,0,'"591"','"Python"',180,3,183
'"39919"','"collective.limitfilesizepanel"','"12"',0,0,0,'"582"','"Python"',41,2,43
'"39963"','"koku-ui"','"19"',0,0,0,'"708"','"Java"',387,0,387
'"40080"','"concerto"','"13"',244,28,272,'"1476"','"Ruby"',2588,167,2755
'"40120"','"Catacomb-Snatch"','"10"',0,0,0,'"745"','"Java"',1539,600,2139
'"40322"','"object_recognition_core"','"17"',7,0,7,'"743"','"Python"',472,5,477
'"40377"','"cloud-manager"','"26"',0,0,0,'"637"','"Ruby"',285,0,285
'"40388"','"split"','"11"',1,3,4,'"1027"','"Ruby"',235,116,351
'"40428"','"akvo-rsr"','"12"',90,14,104,'"1557"','"Python"',1705,45,1750
'"40726"','"rack-contrib"','"14"',0,4,4,'"1898"','"Ruby"',101,55,156
'"40759"','"sinatra.github.com"','"15"',2,3,5,'"1873"','"Ruby"',87,112,199
'"40833"','"maglev"','"14"',40,8,48,'"1865"','"Ruby"',4930,127,5057
'"40841"','"vacuumetrix"','"24"',5,6,11,'"626"','"Ruby"',50,14,64
'"40854"','"cms-ce"','"12"',109,0,109,'"1071"','"Java"',3613,617,4230
'"40882"','"plexus-archiver"','"34"',0,1,1,'"1138"','"Java"',201,13,214
'"40910"','"collective.chimpfeed"','"256"',0,0,0,'"780"','"Python"',209,3,212
'"41004"','"factory_girl_rails"','"74"',10,1,11,'"1382"','"Ruby"',133,46,179
'"41127"','"ftw.book"','"14"',96,7,103,'"822"','"Python"',694,33,727
'"41161"','"izug.ticketbox"','"14"',6,1,7,'"822"','"Python"',380,23,403
'"41180"','"ftw.blog"','"14"',25,6,31,'"827"','"Python"',472,28,500
'"41197"','"ftw.workspace"','"14"',30,4,34,'"827"','"Python"',515,25,540
'"41220"','"hastur-server"','"22"',0,0,0,'"633"','"Ruby"',329,0,329
'"41265"','"sdm"','"18"',0,0,0,'"1197"','"Java"',222,2,224
'"41310"','"EMF-IncQuery"','"11"',0,0,0,'"941"','"Java"',1096,1,1097
'"41339"','"awe-core"','"16"',0,0,0,'"926"','"Java"',1775,1,1776
'"41405"','"Academic-Earth.bundle"','"15"',0,0,0,'"1316"','"Python"',27,6,33
'"41431"','"e2openplugin-AutoBackup"','"22"',0,0,0,'"891"','"Python"',52,1,53
'"41465"','"business-support-finder"','"50"',16,7,23,'"626"','"Ruby"',438,57,495
'"41525"','"drools-planner"','"37"',0,0,0,'"1115"','"Java"',705,14,719
'"41601"','"SOCIETIES-Platform"','"57"',24,0,24,'"874"','"Java"',4884,1,4885
'"41728"','"vumi"','"16"',312,35,347,'"1207"','"Python"',5897,531,6428
'"41741"','"diff_matcher"','"41"',0,0,0,'"901"','"Ruby"',79,1,80
'"41846"','"Ivory"','"10"',0,0,0,'"834"','"Java"',389,4,393
'"41902"','"scape"','"35"',0,0,0,'"1110"','"Java"',261,0,261
'"42018"','"jasmine-gem"','"23"',11,3,14,'"1526"','"Ruby"',266,117,383
'"42086"','"apt"','"26"',12,4,16,'"722"','"Ruby"',149,73,222
'"42087"','"zeroclickinfo-fathead"','"22"',10,2,12,'"976"','"Python"',427,67,494
'"42111"','"collective.linkcheck"','"256"',0,0,0,'"672"','"Python"',55,0,55
'"42120"','"sonar-groovy"','"28"',40,0,40,'"617"','"Java"',164,3,167
'"42153"','"collective.geo.contentlocations"','"256"',8,0,8,'"717"','"Python"',123,3,126
'"42287"','"zojax.portlets.onlinecounter"','"15"',0,0,0,'"581"','"Python"',7,0,7
'"42335"','"inasafe"','"17"',470,28,498,'"787"','"Python"',4588,56,4644
'"42349"','"rapidsms-cvs"','"11"',0,0,0,'"933"','"Python"',330,0,330
'"42418"','"dawn-isenciaui"','"12"',15,0,15,'"779"','"Java"',108,2,110
'"42447"','"patientview"','"11"',180,20,200,'"652"','"Java"',1997,231,2228
'"42568"','"ftw.upgrade"','"13"',13,2,15,'"833"','"Python"',225,22,247
'"42734"','"nuxeo-features"','"22"',187,0,187,'"812"','"Java"',2236,14,2250
'"42750"','"panopticon"','"122"',118,27,145,'"955"','"Ruby"',1311,134,1445
'"42812"','"puppetlabs-firewall"','"59"',47,42,89,'"1034"','"Ruby"',217,229,446
'"42904"','"capify-ec2"','"63"',0,0,0,'"1030"','"Ruby"',140,32,172
'"42937"','"sst-cci-toolbox"','"12"',448,0,448,'"1290"','"Java"',859,0,859
'"42952"','"whitehall"','"123"',1143,110,1253,'"899"','"Ruby"',19034,1294,20328
'"43018"','"restarter.policy"','"12"',0,0,0,'"640"','"Python"',302,0,302
'"43136"','"collective.searchevent"','"256"',0,0,0,'"675"','"Python"',71,0,71
'"43173"','"aruba"','"29"',4,2,6,'"1483"','"Ruby"',85,73,158
'"43506"','"review-o-matic"','"94"',0,0,0,'"618"','"Ruby"',389,1,390
'"43517"','"koku-services"','"19"',0,0,0,'"708"','"Java"',303,0,303
'"43662"','"EasySOA"','"13"',0,0,0,'"1018"','"Java"',1365,1,1366
'"43727"','"cob_robots"','"44"',5,7,12,'"864"','"Python"',447,138,585
'"43735"','"tempo"','"23"',7,15,22,'"1848"','"Java"',1730,138,1868
'"43790"','"collective.backtowork"','"256"',0,0,0,'"793"','"Python"',45,2,47
'"43858"','"cites-meetings"','"11"',119,0,119,'"714"','"Python"',1109,16,1125
'"43875"','"xwiki-platform"','"18"',575,11,586,'"1092"','"Java"',5063,264,5327
'"43986"','"smartworksV3"','"15"',199,0,199,'"856"','"Java"',1754,0,1754
'"44108"','"slimmer"','"82"',23,8,31,'"1058"','"Ruby"',517,60,577
'"44226"','"tme"','"10"',0,0,0,'"786"','"Java"',124,1,125
'"44265"','"webmachine-ruby"','"17"',43,6,49,'"1008"','"Ruby"',241,101,342
'"44476"','"spacewalk-testsuite-base"','"13"',40,4,44,'"680"','"Ruby"',418,4,422
'"44592"','"coffeescript-cookbook.github.com"','"29"',0,1,1,'"1034"','"Ruby"',138,86,224
'"44682"','"tokenserver"','"11"',69,12,81,'"804"','"Python"',419,18,437
'"44967"','"nuxeo"','"22"',109,1,110,'"812"','"Python"',823,3,826
'"45316"','"open-build-service"','"13"',245,27,272,'"966"','"Ruby"',11570,355,11925
'"45348"','"enigma2-plugins"','"19"',23,4,27,'"612"','"Python"',561,8,569
'"45527"','"rapidsms-logistics"','"20"',19,6,25,'"973"','"Python"',505,24,529
'"45614"','"puppetlabs-apache"','"186"',57,78,135,'"1282"','"Ruby"',398,508,906
'"45617"','"nens-geoserver-scripts"','"14"',0,0,0,'"640"','"Python"',15,0,15
'"45658"','"hue"','"34"',288,2,290,'"1354"','"Python"',2217,23,2240
'"45947"','"expertiza"','"18"',33,0,33,'"1248"','"Ruby"',2199,139,2338
'"46099"','"opencounter"','"71"',0,0,0,'"632"','"Ruby"',645,26,671
'"46214"','"111-pod-specs"','"14"',3,1,4,'"731"','"Ruby"',558,96,654
'"46273"','"ec2-plugin"','"307"',7,5,12,'"1178"','"Java"',123,77,200
'"46660"','"lizard-wms"','"13"',2,0,2,'"666"','"Python"',319,12,331
'"46754"','"vim-jp.github.com"','"34"',45,1,46,'"903"','"Ruby"',676,11,687
'"46759"','"ssGWT-lib"','"16"',7,4,11,'"639"','"Java"',431,222,653
'"47421"','"dawn-ui"','"12"',281,0,281,'"779"','"Java"',2261,0,2261
'"47595"','"datawrangling"','"10"',0,0,0,'"960"','"Python"',171,32,203
'"47633"','"core"','"11"',14,15,29,'"1323"','"Java"',260,603,863
'"47817"','"turmeric-eclipse"','"19"',3,0,3,'"1022"','"Java"',182,0,182
'"48024"','"xwiki-commons"','"17"',113,0,113,'"1098"','"Java"',1767,6,1773
'"48033"','"lilyproject"','"13"',22,0,22,'"640"','"Java"',1079,1,1080
'"48168"','"ofSite"','"13"',7,3,10,'"808"','"Python"',754,177,931
'"48273"','"kidsrubyinstaller-windows"','"26"',0,0,0,'"1088"','"Ruby"',69,3,72
'"48485"','"OG-Platform"','"27"',860,1,861,'"1260"','"Java"',12736,10,12746
'"48605"','"tabris"','"12"',26,0,26,'"757"','"Java"',322,0,322
'"48706"','"ESP-Website"','"36"',525,99,624,'"863"','"Python"',8292,406,8698
'"48764"','"cucumber-jvm"','"32"',15,16,31,'"983"','"Java"',918,275,1193
'"48805"','"datacube"','"53"',5,3,8,'"728"','"Java"',146,38,184
'"49127"','"tdiary-core"','"13"',33,8,41,'"1377"','"Ruby"',1388,148,1536
'"49649"','"lastuser"','"10"',33,3,36,'"1113"','"Python"',332,32,364
'"49895"','"Paintroid"','"121"',119,6,125,'"588"','"Java"',2383,125,2508
'"49956"','"omnibus-chef"','"63"',63,10,73,'"688"','"Ruby"',1160,121,1281
'"50013"','"OpenSlides"','"13"',18,18,36,'"583"','"Python"',1567,465,2032
'"50113"','"emesene"','"10"',0,0,0,'"1527"','"Python"',3217,256,3473
'"50119"','"Grammar-Kit"','"13"',18,1,19,'"945"','"Java"',385,8,393
'"50297"','"EggsML"','"25"',275,3,278,'"1409"','"Python"',4142,6,4148
'"50585"','"lizard-damage"','"13"',13,1,14,'"584"','"Python"',409,1,410
'"50901"','"substanced"','"14"',55,11,66,'"703"','"Python"',1215,75,1290
'"51072"','"migratorator"','"93"',0,0,0,'"741"','"Ruby"',301,4,305
'"51151"','"gedcomx"','"10"',2,0,2,'"1044"','"Java"',646,58,704
'"51690"','"dawn-workflow"','"12"',38,0,38,'"779"','"Java"',336,6,342
'"51802"','"dawn-isencia"','"12"',14,0,14,'"779"','"Java"',38,1,39
'"52612"','"pygal"','"15"',40,4,44,'"895"','"Python"',489,29,518
'"52701"','"plek"','"69"',6,1,7,'"899"','"Ruby"',151,14,165
'"52812"','"android-tamilvisai"','"29"',0,0,0,'"966"','"Java"',17,3,20
'"52964"','"stepsovc-dmis-importer"','"58"',0,0,0,'"624"','"Java"',5,0,5
'"52978"','"abiquo"','"29"',0,0,0,'"1128"','"Java"',1453,1,1454
'"53198"','"Weave"','"30"',413,0,413,'"1044"','"Java"',3357,3,3360
'"53403"','"ananya"','"56"',3,0,3,'"808"','"Java"',424,0,424
'"53565"','"systemtests"','"35"',146,0,146,'"875"','"Python"',1019,1,1020
'"53943"','"ella-hub"','"10"',9,0,9,'"588"','"Python"',291,0,291
'"54266"','"META-SHARE"','"13"',1,1,2,'"729"','"Python"',2336,599,2935
'"54307"','"sisu-ldap-testsuite"','"27"',0,0,0,'"1052"','"Java"',43,0,43
'"54473"','"maven-hpi-plugin"','"301"',3,0,3,'"1181"','"Java"',316,7,323
'"54544"','"liquor"','"14"',2,0,2,'"1294"','"Ruby"',200,5,205
'"54725"','"martsearch"','"10"',3,0,3,'"1280"','"Ruby"',271,0,271
'"54738"','"lizard-levee"','"15"',0,0,0,'"618"','"Python"',221,0,221
'"54795"','"createsend-java"','"10"',9,1,10,'"1103"','"Java"',151,8,159
'"54855"','"factual-java-driver"','"20"',0,0,0,'"856"','"Java"',274,1,275
'"54861"','"graph-collections"','"30"',3,0,3,'"997"','"Java"',182,18,200
'"54869"','"lizard-box"','"15"',0,0,0,'"584"','"Python"',86,0,86
'"54878"','"imagej-tutorials"','"14"',15,0,15,'"581"','"Java"',81,1,82
'"54885"','"robot_model_py"','"19"',0,0,0,'"707"','"Python"',42,5,47
'"54895"','"drools-mas"','"37"',0,0,0,'"791"','"Java"',83,27,110
'"55010"','"openfisca"','"13"',0,0,0,'"849"','"Python"',259,167,426
'"55068"','"pymatgen"','"28"',228,8,236,'"865"','"Python"',2241,48,2289
'"55116"','"com.idega.core"','"11"',30,0,30,'"1712"','"Java"',640,0,640
'"55219"','"intellij-community"','"23"',3248,17,3265,'"888"','"Java"',100164,151,100315
'"55521"','"autobahn"','"25"',0,0,0,'"638"','"Ruby"',181,1,182
'"55550"','"Earth-Touch.bundle"','"15"',0,0,0,'"1316"','"Python"',7,4,11
'"55708"','"ananya-reports"','"57"',3,0,3,'"626"','"Java"',238,0,238
'"55719"','"epiwork-website"','"16"',0,0,0,'"976"','"Python"',527,4,531
'"55816"','"collective.quickupload"','"256"',12,0,12,'"745"','"Python"',177,22,199
'"55818"','"Naaya"','"14"',52,0,52,'"1345"','"Python"',554,0,554
'"55838"','"naaya.envirowindows"','"11"',0,0,0,'"779"','"Python"',95,0,95
'"55875"','"trunk-eggs"','"14"',135,0,135,'"779"','"Python"',964,0,964
'"56038"','"pixelprinter"','"96"',0,0,0,'"1739"','"Ruby"',292,5,297
'"56043"','"ftw.tabbedview"','"14"',10,1,11,'"828"','"Python"',510,23,533
'"56047"','"testbed-runtime"','"20"',32,0,32,'"1366"','"Java"',1145,15,1160
'"56447"','"rascal"','"16"',358,1,359,'"591"','"Java"',3347,23,3370
'"56551"','"imagej"','"18"',637,12,649,'"770"','"Java"',4735,22,4757
'"56941"','"signonotron2"','"126"',290,66,356,'"701"','"Ruby"',1189,205,1394
'"57284"','"emas.mobiletheme"','"13"',3,0,3,'"764"','"Python"',329,0,329
'"57396"','"ipython-in-depth"','"11"',1,0,1,'"730"','"Python"',82,2,84
'"57895"','"android_packages_apps_CMWallpapers"','"86"',19,0,19,'"1079"','"Java"',132,2,134
'"57932"','"android_packages_apps_Torch"','"86"',25,0,25,'"1305"','"Java"',232,14,246
'"58058"','"Break.com.bundle"','"15"',0,0,0,'"1243"','"Python"',13,3,16
'"58364"','"software-o-o"','"28"',10,0,10,'"869"','"Ruby"',467,20,487
'"58453"','"smart_server"','"10"',9,0,9,'"1352"','"Python"',433,24,457
'"58755"','"geostore"','"12"',9,2,11,'"678"','"Java"',93,4,97
'"58772"','"buildout.coredev"','"235"',402,5,407,'"893"','"Python"',2400,44,2444
'"58827"','"gds-api-adapters"','"90"',80,18,98,'"825"','"Ruby"',802,125,927
'"58874"','"af"','"14"',1,0,1,'"688"','"Ruby"',185,31,216
'"58896"','"govspeak"','"63"',24,4,28,'"972"','"Ruby"',150,14,164
'"58926"','"aeolus-cli"','"38"',0,0,0,'"960"','"Ruby"',146,4,150
'"59344"','"travis-hub"','"39"',14,1,15,'"849"','"Ruby"',640,22,662
'"59350"','"travis-worker"','"41"',70,4,74,'"1004"','"Ruby"',1077,56,1133
'"59351"','"travis-api"','"39"',39,6,45,'"596"','"Ruby"',769,55,824
'"59455"','"conveyor"','"49"',0,0,0,'"707"','"Python"',828,2,830
'"59490"','"spatial"','"28"',7,3,10,'"1485"','"Java"',230,43,273
'"59499"','"rain"','"13"',0,0,0,'"714"','"Python"',452,0,452
'"59519"','"frontend"','"131"',196,41,237,'"912"','"Ruby"',3166,534,3700
'"59590"','"eventframe"','"11"',6,0,6,'"762"','"Python"',134,4,138
'"59803"','"plone.app.portlets"','"234"',47,3,50,'"893"','"Python"',470,34,504
'"59874"','"sisu-litmus"','"31"',6,0,6,'"912"','"Java"',189,19,208
'"59889"','"plone.app.redirector"','"149"',5,0,5,'"897"','"Python"',102,0,102
'"59903"','"SOCIETIES-SCE-Services"','"34"',16,0,16,'"839"','"Java"',802,4,806
'"59938"','"nbsap"','"11"',0,0,0,'"581"','"Python"',475,1,476
'"60101"','"shopify_app"','"97"',12,4,16,'"1974"','"Ruby"',131,44,175
'"60614"','"anaconda-ec2"','"18"',0,0,0,'"584"','"Python"',9,2,11
'"60686"','"reddeer"','"16"',61,68,129,'"590"','"Java"',382,355,737
'"60891"','"follow-all"','"62"',46,1,47,'"1147"','"Ruby"',563,8,571
'"60918"','"escidoc-core"','"13"',0,0,0,'"615"','"Java"',558,0,558
'"61083"','"collective.geo.kml"','"256"',8,0,8,'"717"','"Python"',132,3,135
'"61157"','"modules-set"','"23"',0,0,0,'"1053"','"Java"',247,0,247
'"61494"','"nuxeo-jsf"','"22"',145,0,145,'"812"','"Java"',1442,5,1447
'"61551"','"fig"','"15"',11,1,12,'"1527"','"Ruby"',483,5,488
'"61616"','"EMF-IncQuery-Examples"','"11"',20,0,20,'"661"','"Java"',399,0,399
'"61662"','"jbpm-form-builder"','"39"',0,0,0,'"668"','"Java"',62,2,64
'"61798"','"databasedotcom"','"13"',0,2,2,'"939"','"Ruby"',77,68,145
'"61987"','"rayo-server"','"27"',0,0,0,'"917"','"Java"',334,0,334
'"62103"','"zonify"','"74"',0,0,0,'"845"','"Ruby"',108,6,114
'"62232"','"buddycloud-media-server"','"15"',58,0,58,'"668"','"Java"',210,13,223
'"62361"','"vcap-services"','"14"',0,0,0,'"1059"','"Ruby"',775,30,805
'"62373"','"ceylon-compiler"','"20"',119,2,121,'"1137"','"Java"',7671,142,7813
'"62385"','"RoboGherk"','"38"',0,0,0,'"603"','"Java"',168,0,168
'"62453"','"postbuildscript-plugin"','"296"',0,0,0,'"927"','"Java"',67,11,78
'"62815"','"phyloShiny"','"22"',0,1,1,'"638"','"Python"',59,4,63
'"62827"','"zojax.authentication"','"16"',3,0,3,'"968"','"Python"',39,0,39
'"62852"','"isfit.org"','"11"',33,0,33,'"1260"','"Ruby"',533,1,534
'"63037"','"capistrano-deploy-tagger"','"14"',2,1,3,'"582"','"Ruby"',21,3,24
'"63090"','"teamdiary"','"15"',0,0,0,'"583"','"Ruby"',23,6,29
'"63247"','"bnet_scraper"','"25"',1,1,2,'"727"','"Ruby"',130,16,146
'"63401"','"datasift-java"','"21"',24,0,24,'"1003"','"Java"',181,37,218
'"64212"','"colander"','"20"',4,7,11,'"1114"','"Python"',153,104,257
'"64317"','"plone.app.users"','"149"',32,4,36,'"893"','"Python"',274,18,292
'"64336"','"rstat.us"','"30"',0,0,0,'"1089"','"Ruby"',596,376,972
'"64396"','"dawn-product"','"12"',20,0,20,'"779"','"Java"',275,1,276
'"64496"','"mongo-connector"','"82"',21,1,22,'"1081"','"Java"',272,7,279
'"64597"','"jenkins-cloud-plugin"','"82"',6,6,12,'"679"','"Java"',44,17,61
'"64609"','"mince_data_model"','"31"',0,0,0,'"735"','"Ruby"',29,0,29
'"64612"','"pdf-watermark"','"10"',0,0,0,'"581"','"Java"',12,0,12
'"64664"','"contribulator"','"25"',0,0,0,'"633"','"Ruby"',18,0,18
'"64930"','"ckanext-demo"','"13"',3,1,4,'"626"','"Python"',50,3,53
'"65187"','"merchant"','"12"',8,5,13,'"1254"','"Python"',248,57,305
'"65190"','"fixmytransport"','"23"',1,0,1,'"1430"','"Ruby"',747,7,754
'"65288"','"pyserial"','"47"',15,0,15,'"616"','"Python"',480,2,482
'"65321"','"tomahawk-android"','"19"',103,0,103,'"600"','"Java"',505,2,507
'"65393"','"CNXFlashCardsApp"','"19"',0,0,0,'"640"','"Java"',185,1,186
'"65399"','"conductor"','"40"',0,0,0,'"883"','"Ruby"',2637,295,2932
'"65445"','"quintagroup.transmogrifier"','"256"',0,0,0,'"679"','"Python"',56,4,60
'"65747"','"ironfan-pantry"','"10"',48,4,52,'"754"','"Ruby"',1233,35,1268
'"65801"','"openmrs-module-omodexport"','"11"',0,0,0,'"589"','"Java"',15,0,15
'"65954"','"andre-sandbox"','"73"',0,0,0,'"630"','"Java"',126,0,126
'"66014"','"basex-api"','"12"',0,0,0,'"1113"','"Java"',1002,79,1081
'"66033"','"pyramid_cookbook"','"14"',2,2,4,'"1166"','"Python"',159,96,255
'"66175"','"dxr"','"10"',99,31,130,'"1017"','"Python"',482,231,713
'"66190"','"OpenTreeMap"','"31"',4,2,6,'"1003"','"Python"',694,137,831
'"66531"','"WBNigeria"','"11"',0,0,0,'"717"','"Python"',629,33,662
'"67112"','"playdoh-lib"','"84"',1,1,2,'"1164"','"Python"',123,57,180
'"67180"','"risotto"','"36"',0,0,0,'"582"','"Java"',27,0,27
'"67190"','"docs"','"14"',20,20,40,'"884"','"Ruby"',345,253,598
'"67315"','"Kanal5Play.bundle"','"15"',1,0,1,'"1094"','"Python"',23,9,32
'"67363"','"motech-delivery"','"61"',0,0,0,'"808"','"Java"',254,0,254
'"67424"','"swagger-codegen"','"24"',40,25,65,'"974"','"Java"',584,79,663
'"67522"','"jagger"','"20"',70,53,123,'"752"','"Java"',563,401,964
'"67620"','"mozilla-ignite"','"14"',3,3,6,'"869"','"Python"',729,132,861
'"67633"','"android-sync"','"10"',563,45,608,'"870"','"Java"',4397,423,4820
'"67640"','"right_support"','"127"',80,17,97,'"1091"','"Ruby"',655,121,776
'"67791"','"ArrayServer"','"18"',0,0,0,'"695"','"Python"',68,0,68
'"67874"','"openmicroscopy"','"50"',213,211,424,'"931"','"Java"',14045,2139,16184
'"67950"','"django-threespot"','"12"',0,0,0,'"1207"','"Python"',97,0,97
'"68102"','"enstaller"','"74"',194,21,215,'"1142"','"Python"',1385,138,1523
'"68155"','"plugin-openshift"','"12"',0,5,5,'"988"','"Java"',33,9,42
'"68382"','"accounting"','"12"',7,0,7,'"911"','"Java"',153,7,160
'"68430"','"facebook-connector"','"97"',10,0,10,'"1053"','"Java"',171,1,172
'"68506"','"auctioneer"','"11"',5,0,5,'"891"','"Java"',97,4,101
'"68537"','"default-broker"','"11"',1,0,1,'"887"','"Java"',103,3,106
'"68572"','"distribution-utility"','"10"',0,0,0,'"903"','"Java"',97,0,97
'"68610"','"JGroups"','"11"',100,12,112,'"1215"','"Java"',16139,128,16267
'"68612"','"factored-customer"','"10"',4,0,4,'"831"','"Java"',128,18,146
'"68661"','"household-customer"','"10"',1,0,1,'"870"','"Java"',156,58,214
'"68687"','"downstream-buildview-plugin"','"296"',0,0,0,'"1179"','"Java"',31,7,38
'"68714"','"genco"','"11"',1,0,1,'"861"','"Java"',72,2,74
'"68862"','"collective.contentleadimage"','"256"',2,1,3,'"859"','"Python"',55,5,60
'"68953"','"simvisage"','"12"',43,0,43,'"736"','"Python"',720,0,720
'"68967"','"monits-commons"','"19"',2,0,2,'"903"','"Java"',105,0,105
'"69056"','"red-fab-deploy"','"31"',0,0,0,'"1106"','"Python"',356,4,360
'"69220"','"Screened.bundle"','"15"',0,0,0,'"848"','"Python"',7,0,7
'"69299"','"nuxeo-drive"','"22"',291,0,291,'"643"','"Python"',1632,6,1638
'"69314"','"plone.app.layout"','"235"',31,5,36,'"893"','"Python"',514,33,547
'"69357"','"solitude"','"25"',21,14,35,'"639"','"Python"',531,200,731
'"69363"','"s3po"','"45"',2,1,3,'"772"','"Python"',26,3,29
'"69654"','"django-navigation"','"13"',1,0,1,'"787"','"Python"',50,0,50
'"69750"','"build-tools"','"11"',105,0,105,'"1232"','"Python"',1243,0,1243
'"69792"','"rhomobile-docs"','"33"',122,4,126,'"1133"','"Ruby"',1384,79,1463
'"69926"','"monitorlib"','"15"',0,0,0,'"667"','"Python"',26,4,30
'"69961"','"escidoc-browser"','"13"',0,0,0,'"883"','"Java"',351,0,351
'"70125"','"innsights-gem"','"14"',0,0,0,'"742"','"Ruby"',114,5,119
'"70160"','"soluvas-framework"','"11"',93,0,93,'"707"','"Java"',1108,0,1108
'"70254"','"artifactory-client-java"','"12"',7,3,10,'"589"','"Java"',103,23,126
'"70387"','"hasgeek.tv"','"11"',12,0,12,'"819"','"Python"',506,63,569
'"70480"','"uPortal"','"25"',246,61,307,'"868"','"Java"',10755,258,11013
'"70486"','"queuey"','"13"',0,0,0,'"875"','"Python"',412,9,421
'"70620"','"JahiApp-Blog"','"23"',5,0,5,'"1053"','"Java"',143,0,143
'"70634"','"mondrian"','"50"',21,17,38,'"717"','"Java"',3736,221,3957
'"70668"','"mule-module-twiml"','"73"',0,0,0,'"905"','"Java"',36,0,36
'"70769"','"rummager"','"112"',53,14,67,'"856"','"Ruby"',1654,190,1844
'"70783"','"adopt-a-hydrant"','"51"',36,1,37,'"1116"','"Ruby"',669,18,687
'"70797"','"s3-connector"','"99"',13,0,13,'"1154"','"Java"',257,5,262
'"70816"','"blood-bank"','"14"',0,0,0,'"976"','"Ruby"',526,1,527
'"70839"','"salesforce-connector"','"88"',43,1,44,'"1119"','"Java"',464,14,478
'"70939"','"mixlib-authentication"','"47"',1,0,1,'"1673"','"Ruby"',63,5,68
'"71042"','"release"','"56"',1,0,1,'"1323"','"Python"',322,1,323
'"71194"','"ldap-tools"','"11"',0,0,0,'"617"','"Java"',51,0,51
'"71334"','"teuthology"','"49"',528,44,572,'"909"','"Python"',3223,214,3437
'"71374"','"data-access"','"51"',10,13,23,'"916"','"Java"',811,393,1204
'"71929"','"scripts"','"36"',8,0,8,'"758"','"Python"',228,0,228
'"71939"','"cvs-plugin"','"313"',0,0,0,'"1179"','"Java"',246,28,274
'"71940"','"vizr"','"14"',0,0,0,'"909"','"Ruby"',222,4,226
'"72063"','"splunk-sdk-java"','"58"',11,1,12,'"1021"','"Java"',806,49,855
'"72186"','"g5engsite"','"35"',6,1,7,'"595"','"Ruby"',96,6,102
'"72578"','"scholarsphere"','"10"',66,0,66,'"889"','"Ruby"',1502,6,1508
'"72907"','"django-example"','"36"',1,2,3,'"939"','"Python"',65,22,87
'"72932"','"rubygems-mirror"','"11"',0,0,0,'"1333"','"Ruby"',40,8,48
'"73066"','"elzar"','"10"',0,0,0,'"818"','"Ruby"',161,0,161
'"73635"','"dg"','"12"',249,20,269,'"848"','"Java"',3618,186,3804
'"73683"','"metlog-hive"','"11"',0,0,0,'"584"','"Java"',31,1,32
'"73747"','"solar"','"24"',127,0,127,'"1203"','"Ruby"',1236,2,1238
'"74061"','"pulsetranslator"','"16"',1,0,1,'"721"','"Python"',26,1,27
'"74063"','"omnibus-ruby"','"46"',97,15,112,'"751"','"Ruby"',612,99,711
'"74349"','"ella"','"11"',9,1,10,'"1841"','"Python"',626,49,675
'"74716"','"GamesPlatform-Android"','"43"',0,0,0,'"808"','"Java"',71,0,71
'"74867"','"nhs-patientlist"','"11"',0,0,0,'"649"','"Ruby"',272,2,274
'"75058"','"vaurien"','"11"',0,2,2,'"587"','"Python"',128,17,145
'"75197"','"circuit"','"13"',0,0,0,'"744"','"Ruby"',87,2,89
'"75274"','"eea.facetednavigation"','"256"',18,1,19,'"765"','"Python"',226,13,239
'"75312"','"BrowserID-Tests"','"23"',0,0,0,'"819"','"Python"',55,40,95
'"75335"','"factual-python-driver"','"10"',5,0,5,'"742"','"Python"',138,4,142
'"75462"','"zipwhip-common-util"','"11"',8,0,8,'"929"','"Java"',191,1,192
'"75605"','"conceptnet5"','"32"',43,1,44,'"897"','"Python"',211,1,212
'"75619"','"fiji"','"11"',196,8,204,'"1058"','"Java"',2193,47,2240
'"75761"','"fhwa2_viz"','"14"',0,0,0,'"659"','"Python"',171,0,171
'"75812"','"omnibus-software"','"81"',115,19,134,'"689"','"Ruby"',608,115,723
'"75832"','"ion-ux"','"43"',103,89,192,'"847"','"Python"',1568,337,1905
'"75984"','"puppetlabs-release"','"24"',3,3,6,'"611"','"Ruby"',18,11,29
'"76303"','"one80"','"18"',0,0,0,'"933"','"Python"',128,0,128
'"76416"','"hash_dealer"','"15"',0,0,0,'"938"','"Ruby"',104,0,104
'"76527"','"littlechef-servers"','"10"',7,0,7,'"658"','"Ruby"',270,0,270
'"76547"','"right_api_client"','"64"',37,5,42,'"1228"','"Ruby"',215,30,245
'"76800"','"mojo"','"12"',0,0,0,'"702"','"Python"',97,0,97
'"76978"','"eternity"','"19"',0,0,0,'"1508"','"Ruby"',626,0,626
'"77354"','"bittorrent.org"','"32"',4,0,4,'"1073"','"Python"',102,4,106
'"77796"','"magic-config-api"','"12"',0,0,0,'"844"','"Java"',30,4,34
'"77860"','"magic-config"','"12"',0,0,0,'"853"','"Java"',66,7,73
'"77954"','"dt-data"','"41"',1,0,1,'"1150"','"Ruby"',334,0,334
'"78275"','"coshx"','"15"',62,13,75,'"924"','"Ruby"',741,17,758
'"78373"','"netbeans-stapler-plugin"','"11"',0,0,0,'"595"','"Java"',45,0,45
'"78393"','"sisu-guice"','"27"',12,1,13,'"1282"','"Java"',215,3,218
'"78578"','"rspec-spies"','"11"',0,0,0,'"1582"','"Ruby"',29,17,46
'"78857"','"startonrails"','"14"',0,0,0,'"666"','"Ruby"',71,0,71
'"78962"','"honolulu_answers"','"75"',0,0,0,'"692"','"Ruby"',705,35,740
'"79429"','"docs-style"','"10"',15,0,15,'"701"','"Java"',280,67,347
'"79561"','"ohmagePhone"','"18"',0,0,0,'"1284"','"Java"',491,0,491
'"80875"','"buildout.jenkins"','"235"',0,0,0,'"844"','"Python"',138,10,148
'"81325"','"plone.app.discussion"','"231"',21,3,24,'"893"','"Python"',488,39,527
'"81423"','"docs"','"22"',18,0,18,'"765"','"Python"',295,8,303
'"81622"','"asteroids"','"19"',0,0,0,'"610"','"Python"',61,0,61
'"81866"','"OurGrid"','"10"',0,0,0,'"905"','"Java"',321,0,321
'"81935"','"android-demo-OAuth20"','"15"',0,0,0,'"580"','"Java"',2,0,2
'"82124"','"hgapp"','"11"',0,0,0,'"741"','"Python"',38,2,40
'"82195"','"Addon-Tests"','"40"',9,6,15,'"1030"','"Python"',1173,668,1841
'"82501"','"ks"','"22"',5,1,6,'"700"','"Java"',4699,233,4932
'"82945"','"mms_engine"','"10"',1,0,1,'"1493"','"Ruby"',314,0,314
'"83087"','"django-fhadmin"','"11"',0,0,0,'"1092"','"Python"',25,0,25
'"83095"','"knife-azure"','"71"',51,11,62,'"638"','"Ruby"',582,127,709
'"83274"','"codekata"','"15"',0,0,0,'"603"','"Ruby"',96,16,112
'"83349"','"transmogrify.filesystem"','"256"',0,0,0,'"767"','"Python"',35,1,36
'"84164"','"checkstyle-plugin"','"301"',8,0,8,'"1179"','"Java"',277,2,279
'"84183"','"flip"','"22"',0,0,0,'"830"','"Java"',86,0,86
'"84335"','"deploy_docus"','"21"',0,0,0,'"860"','"Ruby"',42,0,42
'"84749"','"homebrew-tomahawk"','"19"',10,0,10,'"679"','"Ruby"',71,2,73
'"84891"','"oulu"','"11"',0,2,2,'"709"','"Ruby"',272,40,312
'"84985"','"integration"','"10"',15,10,25,'"701"','"Java"',319,89,408
'"85181"','"bot-thrust"','"75"',0,0,0,'"582"','"Python"',12,0,12
'"85396"','"m2e-apt"','"15"',0,0,0,'"805"','"Java"',36,6,42
'"85527"','"sandbox"','"17"',0,0,0,'"937"','"Java"',142,1,143
'"85746"','"MR-connectome"','"12"',101,0,101,'"1043"','"Python"',435,0,435
'"85998"','"collective.z3cform.datagridfield"','"256"',2,0,2,'"898"','"Python"',172,11,183
'"86017"','"redturtle.video"','"12"',0,0,0,'"734"','"Python"',155,4,159
'"86192"','"plone.app.contentrules"','"149"',10,1,11,'"893"','"Python"',212,5,217
'"86221"','"android-workshop"','"36"',0,0,0,'"1128"','"Java"',52,0,52
'"86238"','"need-o-tron"','"91"',2,1,3,'"1001"','"Ruby"',568,15,583
'"86430"','"addons"','"20"',10,0,10,'"812"','"Python"',248,0,248
'"86448"','"nuxeo-theme"','"22"',10,0,10,'"812"','"Java"',385,0,385
'"86461"','"nuxeo-jboss-jca-configurator"','"22"',7,0,7,'"812"','"Java"',77,0,77
'"86462"','"nuxeo-core-binarymanager-sql"','"22"',10,0,10,'"812"','"Java"',97,0,97
'"86463"','"nuxeo-correspondence-marianne"','"22"',7,0,7,'"812"','"Java"',84,0,84
'"86465"','"nuxeo-chemistry"','"22"',19,0,19,'"812"','"Java"',426,6,432
'"86469"','"nuxeo-platform-faceted-search"','"22"',16,0,16,'"812"','"Java"',367,1,368
'"86480"','"nuxeo-platform-video"','"22"',14,0,14,'"812"','"Java"',295,0,295
'"86490"','"nuxeo-filesystem-connectors"','"22"',8,0,8,'"812"','"Java"',281,1,282
'"86507"','"nuxeo-birt"','"22"',10,0,10,'"1100"','"Java"',163,0,163
'"86516"','"nuxeo-platform-indexing-gateway"','"22"',7,0,7,'"780"','"Java"',113,0,113
'"86524"','"nuxeo-platform-replication"','"22"',3,0,3,'"812"','"Java"',181,0,181
'"86579"','"nuxeo-rss-reader"','"22"',9,0,9,'"1031"','"Java"',203,0,203
'"86589"','"ftw.pdfgenerator"','"13"',27,7,34,'"848"','"Python"',296,12,308
'"86615"','"envinject-lib"','"296"',0,0,0,'"787"','"Java"',69,3,72
'"86653"','"xtrigger-lib"','"296"',0,0,0,'"809"','"Java"',104,2,106
'"86681"','"nuxeo-platform-user-registration"','"22"',10,0,10,'"812"','"Java"',138,1,139
'"86690"','"fstrigger-plugin"','"296"',0,0,0,'"975"','"Java"',114,0,114
'"86740"','"nuxeo-platform-document-routing"','"22"',22,0,22,'"812"','"Java"',691,0,691
'"86782"','"memo-nodes"','"10"',0,0,0,'"745"','"Java"',115,0,115
'"86821"','"ftw.task"','"13"',3,0,3,'"630"','"Python"',123,7,130
'"87167"','"collective.contentlicensing"','"256"',3,0,3,'"905"','"Python"',107,6,113
'"87535"','"nuxeo-opensocial"','"22"',23,0,23,'"812"','"Java"',412,5,417
'"87660"','"AutomationServerManager"','"15"',0,0,0,'"848"','"Python"',83,0,83
'"87666"','"smdba"','"13"',2,0,2,'"617"','"Python"',119,1,120
'"87798"','"oerpub.rhaptoslabs.slideimporter"','"14"',0,0,0,'"678"','"Python"',50,0,50
'"87800"','"wishlisting"','"10"',0,0,0,'"652"','"Ruby"',116,0,116
'"87878"','"com.idega.block.trade"','"10"',5,0,5,'"1688"','"Java"',115,0,115
'"87885"','"smart_client_python"','"10"',3,0,3,'"1294"','"Python"',125,9,134
'"87890"','"designdiscussions"','"19"',2,0,2,'"667"','"Python"',148,0,148
'"88470"','"plone.app.form"','"235"',4,1,5,'"897"','"Python"',257,5,262
'"88761"','"oerpub.rhaptoslabs.slideimporter.appengine"','"14"',0,0,0,'"580"','"Python"',5,0,5
'"88803"','"scripts"','"23"',2,0,2,'"1169"','"Ruby"',116,1,117
'"88971"','"nuxeo-dm"','"22"',123,0,123,'"812"','"Java"',1147,7,1154
'"89067"','"itm-utils"','"15"',5,0,5,'"990"','"Java"',151,0,151
'"89114"','"transifex-client"','"10"',0,1,1,'"703"','"Python"',297,13,310
'"89211"','"adaptor-template"','"14"',0,0,0,'"609"','"Ruby"',75,5,80
'"89329"','"nuxeo-services"','"22"',55,0,55,'"812"','"Java"',784,12,796
'"89512"','"openmrs-module-metadatasharing"','"33"',0,0,0,'"743"','"Java"',112,17,129
'"89519"','"mpi2_solr"','"12"',2,0,2,'"673"','"Ruby"',188,1,189
'"89669"','"webgrouper"','"10"',21,0,21,'"738"','"Ruby"',432,0,432
'"89745"','"yuicompressor"','"14"',1,2,3,'"1917"','"Java"',65,61,126
'"89957"','"oerpub.rhaptoslabs.html_gdocs2cnxml"','"14"',0,0,0,'"862"','"Python"',166,5,171
'"90214"','"JahiApp-Wiki"','"23"',5,0,5,'"1053"','"Java"',217,0,217
'"90396"','"barclamp-ceph"','"20"',0,0,0,'"847"','"Ruby"',36,3,39
'"90407"','"tarantool-ruby"','"23"',2,0,2,'"822"','"Ruby"',221,15,236
'"90432"','"ceph-cookbooks"','"30"',8,14,22,'"904"','"Ruby"',195,86,281
'"90442"','"dateable.chronos"','"256"',0,0,0,'"762"','"Python"',57,3,60
'"90550"','"nuxeo-rating"','"22"',8,0,8,'"728"','"Java"',120,2,122
'"90565"','"nuxeo-agenda"','"22"',10,1,11,'"688"','"Java"',118,1,119
'"90680"','"bourne"','"66"',0,0,0,'"1366"','"Ruby"',43,22,65
'"90866"','"django-ldapauth"','"11"',0,0,0,'"1274"','"Python"',57,0,57
'"90922"','"zojax.content.actions"','"16"',1,0,1,'"968"','"Python"',11,0,11
'"90939"','"ops_gems"','"44"',0,0,0,'"832"','"Ruby"',100,2,102
'"91005"','"zojax.usermanual"','"16"',1,0,1,'"968"','"Python"',37,0,37
'"91064"','"nexpose-client"','"42"',18,2,20,'"867"','"Ruby"',312,16,328
'"91199"','"autoscalebot"','"15"',0,0,0,'"740"','"Python"',99,2,101
'"91356"','"chitools"','"50"',0,0,0,'"706"','"Python"',50,0,50
'"91668"','"wsn-device-drivers"','"12"',0,0,0,'"1064"','"Java"',335,6,341
'"91722"','"wsn-device-utils"','"15"',0,0,0,'"1030"','"Java"',148,3,151
'"91762"','"udig-platform"','"16"',5,0,5,'"1109"','"Java"',2265,177,2442
'"91844"','"trunion"','"204"',0,0,0,'"679"','"Python"',75,11,86
'"92010"','"eng_archive"','"10"',62,6,68,'"960"','"Python"',400,29,429
'"92224"','"dgi-db"','"41"',37,2,39,'"633"','"Ruby"',759,2,761
'"92499"','"munin-collector"','"10"',0,0,0,'"916"','"Python"',90,0,90
'"92535"','"molgenis"','"31"',155,155,310,'"1353"','"Java"',1620,986,2606
'"93173"','"python-superfastmatch"','"15"',1,0,1,'"905"','"Python"',100,0,100
'"93179"','"splendidbacon"','"11"',0,0,0,'"1231"','"Ruby"',297,2,299
'"93314"','"formtranslate"','"12"',0,0,0,'"1092"','"Python"',45,5,50
'"93408"','"tassadar"','"26"',1,0,1,'"944"','"Ruby"',25,7,32
'"93992"','"state-history-validator"','"13"',0,0,0,'"608"','"Ruby"',33,1,34
'"94211"','"hibernate-tools"','"16"',4,1,5,'"1093"','"Java"',113,39,152
'"94297"','"yum"','"26"',57,6,63,'"722"','"Ruby"',239,69,308
'"94375"','"nexus-maven-plugins"','"30"',26,2,28,'"630"','"Java"',474,47,521
'"94837"','"hacktheplanet.github.com"','"21"',0,0,0,'"759"','"Ruby"',59,1,60
'"95140"','"c3ma_roomservice"','"10"',0,0,0,'"580"','"Python"',2,0,2
'"95180"','"horizon"','"21"',7,9,16,'"702"','"Ruby"',114,152,266
'"95328"','"magento-connector"','"98"',4,0,4,'"1148"','"Java"',176,5,181
'"95329"','"ecto"','"10"',23,0,23,'"1015"','"Python"',402,47,449
'"95369"','"churnalism_us"','"17"',0,0,0,'"764"','"Python"',366,0,366
'"95619"','"WikipediaMobileJ2ME"','"10"',3,0,3,'"632"','"Java"',163,2,165
'"96148"','"redness"','"28"',0,0,0,'"692"','"Ruby"',70,2,72
'"96286"','"tagtical"','"18"',0,0,0,'"988"','"Ruby"',144,4,148
'"96349"','"JamomaDoc"','"14"',26,0,26,'"1242"','"Ruby"',179,0,179
'"96622"','"mock_redis"','"39"',12,1,13,'"973"','"Ruby"',108,57,165
'"96966"','"xwiki-platform-solr"','"21"',0,0,0,'"646"','"Java"',48,0,48
'"97294"','"environment-script-plugin"','"296"',0,0,0,'"580"','"Java"',20,1,21
'"97464"','"docs-ecosystem"','"47"',10,15,25,'"625"','"Python"',282,140,422
'"98612"','"code_critic"','"14"',0,0,0,'"601"','"Ruby"',142,0,142
'"99256"','"ZenPacks.zenoss.RabbitMQ"','"22"',0,0,0,'"896"','"Python"',62,2,64
'"99336"','"homebrew_formulaes"','"23"',0,0,0,'"821"','"Ruby"',13,0,13
'"100052"','"Pynuts"','"15"',0,0,0,'"693"','"Python"',375,1,376
'"101573"','"catalog-api-client"','"12"',0,0,0,'"1062"','"Java"',117,0,117
'"101970"','"MiFirma"','"10"',32,0,32,'"1366"','"Ruby"',189,0,189
'"102437"','"plone.app.controlpanel"','"231"',48,4,52,'"893"','"Python"',565,21,586
'"102997"','"django-design-patterns"','"12"',0,0,0,'"1722"','"Python"',75,10,85
'"103227"','"mail_sandbox"','"12"',0,0,0,'"603"','"Ruby"',29,0,29
'"103257"','"android-client"','"20"',0,0,0,'"1017"','"Java"',79,0,79
'"103283"','"icfpc2012-tbd"','"13"',0,0,0,'"611"','"Python"',97,0,97
'"103429"','"spynner"','"19"',1,1,2,'"1001"','"Python"',92,5,97
'"103508"','"HUSACCT"','"14"',40,0,40,'"715"','"Java"',1431,187,1618
'"103713"','"elasticsearch-jetty"','"27"',13,2,15,'"906"','"Java"',139,31,170
'"103874"','"pretty_face"','"10"',2,0,2,'"665"','"Ruby"',215,7,222
'"104115"','"BigJob"','"10"',28,0,28,'"793"','"Python"',801,1,802
'"104370"','"sphinxcontrib-fulltoc"','"24"',0,0,0,'"579"','"Python"',15,1,16
'"104378"','"nss"','"10"',4,0,4,'"991"','"Python"',518,1,519
'"104695"','"curso-hacker-2012"','"11"',0,0,0,'"730"','"Python"',100,0,100
'"104697"','"xwiki-enterprise"','"17"',40,0,40,'"1094"','"Java"',2654,57,2711
'"105474"','"metabbotcfg"','"10"',1,0,1,'"1335"','"Python"',123,5,128
'"105576"','"xwiki-rendering"','"17"',20,0,20,'"1106"','"Java"',449,8,457
'"105588"','"mail_sandbox_web"','"12"',0,0,0,'"579"','"Ruby"',271,6,277
'"105686"','"gemcutter"','"31"',0,0,0,'"951"','"Ruby"',110,4,114
'"105762"','"akvo-flow"','"13"',104,3,107,'"709"','"Java"',1771,5,1776
'"106429"','"artifactdeployer-plugin"','"296"',0,0,0,'"1012"','"Java"',97,3,100
'"106900"','"plone.testing"','"149"',8,0,8,'"898"','"Python"',116,7,123
'"106938"','"plone.stringinterp"','"149"',3,0,3,'"897"','"Python"',99,4,103
'"107034"','"plone.outputfilters"','"235"',0,0,0,'"897"','"Python"',113,8,121
'"107052"','"plone.app.iterate"','"149"',6,3,9,'"897"','"Python"',111,10,121
'"107290"','"KBDH-VN"','"13"',13,0,13,'"728"','"Python"',845,4,849
'"107349"','"plone.recipe.zope2instance"','"149"',5,2,7,'"897"','"Python"',103,11,114
'"107561"','"collective.folderlogo"','"255"',0,0,0,'"583"','"Python"',23,0,23
'"107759"','"envinject-plugin"','"308"',0,0,0,'"964"','"Java"',354,18,372
'"107830"','"toast.js"','"20"',0,0,0,'"752"','"Ruby"',53,1,54
'"107842"','"stirling"','"13"',0,0,0,'"1374"','"Java"',338,164,502
'"107969"','"jclouds-plugin"','"313"',19,10,29,'"1179"','"Java"',258,59,317
'"109748"','"slc.smtp2zope"','"23"',0,0,0,'"715"','"Python"',24,0,24
'"109764"','"slc.mailrouter"','"23"',0,0,0,'"754"','"Python"',129,0,129
'"110030"','"ape"','"16"',1,0,1,'"660"','"Python"',110,1,111
'"110607"','"plone.api"','"230"',4,2,6,'"740"','"Python"',796,62,858
'"110998"','"tutorials_devel"','"10"',1,0,1,'"841"','"Python"',116,0,116
'"111425"','"danbooru"','"18"',87,0,87,'"1491"','"Ruby"',1914,31,1945
'"111875"','"sonar-python"','"26"',0,0,0,'"617"','"Java"',177,0,177
'"112319"','"build-info"','"12"',12,0,12,'"1110"','"Java"',402,28,430
'"112466"','"bamboo-artifactory-plugin"','"12"',0,0,0,'"848"','"Java"',170,0,170
'"112751"','"sprockets-rails"','"32"',9,5,14,'"1019"','"Ruby"',112,59,171
'"113198"','"devst_awaji_monkey"','"26"',0,0,0,'"727"','"Java"',1,0,1
'"113230"','"raffle"','"10"',0,0,0,'"614"','"Ruby"',150,5,155
'"114424"','"fcrepo"','"14"',0,0,0,'"1179"','"Java"',220,17,237
'"114529"','"oerpub.rhaptoslabs.swordpushweb-buildout"','"16"',0,0,0,'"884"','"Python"',132,2,134
'"114675"','"store_engine"','"17"',0,0,0,'"610"','"Ruby"',40,6,46
'"114886"','"iivari"','"13"',0,0,0,'"1386"','"Ruby"',112,0,112
'"114990"','"collective.generic.skel"','"255"',9,0,9,'"1156"','"Python"',132,3,135
'"115228"','"qi4j-sdk"','"16"',112,2,114,'"1195"','"Java"',703,21,724
'"115565"','"plone.app.registry"','"149"',0,0,0,'"897"','"Python"',118,6,124
'"115587"','"caphub"','"22"',3,0,3,'"853"','"Ruby"',11,5,16
'"115646"','"museotouch"','"12"',5,0,5,'"701"','"Python"',27,1,28
'"116058"','"flutie"','"41"',0,0,0,'"1688"','"Ruby"',232,21,253
'"116115"','"plone.app.multilingual"','"235"',22,1,23,'"980"','"Python"',453,45,498
'"116216"','"BikeBinder"','"11"',7,0,7,'"743"','"Ruby"',329,0,329
'"117304"','"django-honeypot"','"13"',4,1,5,'"1779"','"Python"',12,3,15
'"117305"','"was-builder-plugin"','"307"',0,0,0,'"1179"','"Java"',35,0,35
'"117362"','"waitress"','"14"',0,0,0,'"810"','"Python"',79,31,110
'"117683"','"skype-im-plugin"','"307"',0,0,0,'"1179"','"Java"',3,2,5
'"117823"','"collective.cart.shipping"','"322"',0,0,0,'"618"','"Python"',74,0,74
'"118093"','"chef-fundamentals"','"52"',0,0,0,'"820"','"Ruby"',24,7,31
'"118213"','"wordnik-oss"','"25"',0,0,0,'"1239"','"Java"',104,5,109
'"118297"','"e2openplugin-Foreca"','"22"',0,0,0,'"860"','"Python"',70,9,79
'"118301"','"railsgirls.github.com"','"242"',35,23,58,'"687"','"Ruby"',274,137,411
'"118422"','"unicorn"','"26"',0,0,0,'"722"','"Ruby"',10,7,17
'"118430"','"passenger_apache2"','"26"',4,0,4,'"722"','"Ruby"',58,25,83
'"118597"','"pg_search_scope"','"24"',0,0,0,'"969"','"Ruby"',7,0,7
'"118604"','"resque-ensure-connected"','"30"',0,0,0,'"1186"','"Ruby"',15,0,15
'"118823"','"wolverine"','"102"',1,0,1,'"735"','"Ruby"',22,5,27
'"118871"','"pg_global_search"','"14"',0,0,0,'"664"','"Ruby"',18,4,22
'"118997"','"collective.elections"','"319"',0,0,0,'"841"','"Python"',143,1,144
'"119061"','"humanizer"','"14"',2,1,3,'"1349"','"Ruby"',29,22,51
'"119078"','"tinder"','"12"',12,2,14,'"2217"','"Ruby"',144,33,177
'"119313"','"rapidsms-twilio"','"12"',0,0,0,'"1319"','"Python"',65,5,70
'"119533"','"nbconvert"','"19"',0,0,0,'"724"','"Python"',327,117,444
'"119656"','"mygengo-python"','"10"',0,0,0,'"1012"','"Python"',62,11,73
'"120232"','"droolsjbpm-integration"','"37"',131,3,134,'"1116"','"Java"',861,78,939
'"121195"','"biom-format"','"13"',1,1,2,'"694"','"Python"',344,110,454
'"122473"','"serengeti-ws"','"26"',62,0,62,'"635"','"Java"',1129,2,1131
'"122605"','"stardog-spring"','"11"',5,0,5,'"964"','"Java"',45,0,45
'"122606"','"zk"','"17"',31,2,33,'"1021"','"Java"',804,54,858
'"122716"','"zojax.containertraverser"','"16"',1,0,1,'"590"','"Python"',22,0,22
'"123016"','"time-logging"','"12"',0,0,0,'"727"','"Ruby"',304,0,304
'"123437"','"salt-contrib"','"18"',14,6,20,'"836"','"Python"',85,62,147
'"123568"','"oe-alliance-plugins"','"20"',44,1,45,'"617"','"Python"',543,11,554
'"123740"','"demo"','"26"',0,0,0,'"1160"','"Ruby"',8,3,11
'"123745"','"promoted-builds-plugin"','"317"',10,6,16,'"1179"','"Java"',144,39,183
'"123803"','"curator"','"24"',5,4,9,'"762"','"Ruby"',118,20,138
'"123858"','"smartcoops"','"15"',0,0,0,'"613"','"Python"',71,1,72
'"124263"','"seismichadoop"','"19"',0,0,0,'"777"','"Java"',3,1,4
'"124313"','"hadoop-pcap"','"10"',0,0,0,'"886"','"Java"',42,10,52
'"124389"','"heroku_sinatra_example"','"12"',0,0,0,'"813"','"Ruby"',28,2,30
'"124887"','"redmine-treeview"','"15"',0,0,0,'"953"','"Ruby"',153,0,153
'"125032"','"Products.Archetypes"','"234"',15,4,19,'"889"','"Python"',471,38,509
'"125211"','"indeed"','"14"',0,0,0,'"1228"','"Ruby"',1,1,2
'"125250"','"isono"','"11"',0,0,0,'"1392"','"Ruby"',274,7,281
'"125344"','"cirb.organizations"','"12"',0,0,0,'"763"','"Python"',141,0,141
'"125357"','"dawn-common"','"12"',94,0,94,'"779"','"Java"',964,5,969
'"125545"','"Social-module"','"23"',16,0,16,'"786"','"Java"',145,0,145
'"125595"','"maven-invoker-plugin"','"296"',0,0,0,'"601"','"Java"',60,0,60
'"125612"','"ftw.dashboard.dragndrop"','"14"',0,0,0,'"825"','"Python"',193,15,208
'"125673"','"lizard-map"','"15"',35,5,40,'"888"','"Python"',741,14,755
'"125696"','"cypher-dsl"','"23"',7,2,9,'"884"','"Java"',139,15,154
'"126388"','"stompjms"','"24"',8,0,8,'"1144"','"Java"',67,7,74
'"126426"','"mokmok"','"33"',0,0,0,'"605"','"Ruby"',29,1,30
'"126759"','"wicket-openid"','"59"',6,0,6,'"829"','"Java"',319,0,319
'"126795"','"publicdb"','"12"',53,1,54,'"749"','"Python"',896,4,900
'"126854"','"baton"','"29"',0,0,0,'"702"','"Ruby"',128,25,153
'"126912"','"oer.exports"','"24"',181,20,201,'"624"','"Python"',1686,171,1857
'"127408"','"box-android-sdk"','"10"',1,0,1,'"954"','"Java"',69,9,78
'"127514"','"nexus-capabilities-plugin"','"28"',0,0,0,'"820"','"Java"',329,24,353
'"127863"','"planner"','"96"',0,0,0,'"890"','"Ruby"',257,10,267
'"127990"','"plf-bonita"','"15"',0,0,0,'"701"','"Java"',54,0,54
'"128005"','"tesb-rt-se"','"66"',23,1,24,'"1168"','"Java"',986,21,1007
'"128030"','"django-salmonella"','"12"',0,0,0,'"1044"','"Python"',21,10,31
'"128079"','"eestec.portal"','"10"',0,0,0,'"632"','"Python"',205,11,216
'"128101"','"sdm2"','"20"',0,0,0,'"612"','"Java"',323,0,323
'"128114"','"JahiApp-MyConnections"','"23"',4,0,4,'"1053"','"Java"',233,0,233
'"128299"','"Transit2Me"','"75"',0,0,0,'"586"','"Ruby"',225,0,225
'"128476"','"imminence"','"93"',10,5,15,'"946"','"Ruby"',657,84,741
'"128593"','"ceylon-runtime"','"14"',6,0,6,'"1107"','"Java"',324,4,328
'"128620"','"ceylon-module-resolver"','"14"',9,1,10,'"832"','"Java"',405,5,410
'"128642"','"project-setup"','"10"',0,0,0,'"598"','"Ruby"',15,0,15
'"128749"','"mozmill-ci"','"41"',4,9,13,'"804"','"Python"',257,220,477
'"128819"','"zojax.calendar"','"16"',3,0,3,'"968"','"Python"',85,0,85
'"128840"','"gocardless-python"','"21"',6,1,7,'"758"','"Python"',104,15,119
'"128841"','"correlation"','"12"',0,0,0,'"660"','"Python"',54,0,54
'"128939"','"django-mediagenerator"','"33"',0,0,0,'"806"','"Python"',74,1,75
'"128945"','"patella"','"24"',0,0,0,'"682"','"Ruby"',23,1,24
'"129095"','"openldap"','"26"',0,3,3,'"722"','"Ruby"',31,30,61
'"129214"','"Products.CMFEditions"','"236"',0,0,0,'"838"','"Python"',325,11,336
'"129340"','"grntest"','"19"',4,0,4,'"734"','"Ruby"',366,1,367
'"129447"','"buildresult-trigger-plugin"','"317"',1,1,2,'"942"','"Java"',77,8,85
'"129625"','"Products.PloneboardSubscription"','"320"',0,0,0,'"575"','"Python"',28,1,29
'"129879"','"collective.azindexpage"','"322"',0,0,0,'"624"','"Python"',42,1,43
'"130082"','"disk-usage-plugin"','"307"',0,0,0,'"1179"','"Java"',53,17,70
'"130248"','"iwwb.eventlist"','"322"',0,0,0,'"779"','"Python"',103,0,103
'"130401"','"calendar"','"14"',12,2,14,'"651"','"Java"',272,52,324
'"130423"','"pugg"','"10"',0,0,0,'"720"','"Python"',146,0,146
'"130459"','"right_rackspace"','"87"',0,0,0,'"1717"','"Ruby"',68,9,77
'"130554"','"python-toolbox2"','"15"',0,0,0,'"1049"','"Python"',139,0,139
'"130650"','"sep100"','"10"',0,0,0,'"590"','"Python"',6,0,6
'"130682"','"futuresimple.github.com"','"15"',0,0,0,'"1054"','"Ruby"',27,0,27
'"130876"','"collective.recipe.plonesite"','"322"',1,1,2,'"618"','"Python"',110,3,113
'"131027"','"collective.polls"','"322"',0,0,0,'"821"','"Python"',466,29,495
'"131138"','"rspec-http"','"18"',0,0,0,'"1066"','"Ruby"',21,2,23
'"131270"','"sqlalchemy"','"14"',0,0,0,'"756"','"Python"',9,0,9
'"131283"','"nuxeo-jenkins-report"','"22"',5,0,5,'"580"','"Java"',72,0,72
'"131406"','"stackmob-android-starter"','"22"',0,0,0,'"805"','"Java"',70,3,73
'"131468"','"quimby"','"24"',1,2,3,'"1148"','"Ruby"',99,18,117
'"131689"','"pycollector"','"10"',0,0,0,'"975"','"Python"',573,2,575
'"131819"','"instance-identity-module"','"47"',0,0,0,'"1084"','"Java"',15,0,15
'"131878"','"javaws-kludge"','"29"',0,0,0,'"692"','"Python"',2,0,2
'"131909"','"moztrap-vendor-lib"','"12"',0,0,0,'"874"','"Python"',29,1,30
'"132014"','"tandem"','"11"',8,3,11,'"1462"','"Ruby"',430,72,502
'"132159"','"nexus"','"16"',16,0,16,'"1048"','"Java"',358,0,358
'"132240"','"serial-barcode-scanner"','"10"',8,0,8,'"653"','"Python"',247,5,252
'"132254"','"django-academy"','"11"',0,0,0,'"689"','"Python"',117,0,117
'"132265"','"tandem-demo"','"12"',0,0,0,'"717"','"Ruby"',10,1,11
'"132300"','"blc-usps"','"12"',0,0,0,'"577"','"Java"',92,0,92
'"132464"','"blc-cybersource"','"12"',0,0,0,'"577"','"Java"',8,0,8
'"132560"','"bottle-currency"','"15"',0,0,0,'"689"','"Python"',16,0,16
'"132590"','"marine-integrations"','"10"',24,12,36,'"682"','"Python"',1122,146,1268
'"132747"','"django-gtd"','"15"',0,0,0,'"689"','"Python"',45,0,45
'"132771"','"ckanext-qa"','"14"',0,0,0,'"953"','"Python"',158,3,161
'"132911"','"grex"','"11"',0,0,0,'"1015"','"Ruby"',169,0,169
'"133365"','"external-monitor-job-plugin"','"317"',0,0,0,'"645"','"Java"',106,6,112
'"133495"','"AndroidCourseResources"','"69"',0,0,0,'"579"','"Java"',70,1,71
'"133633"','"legislativo-api-java"','"11"',0,0,0,'"777"','"Java"',0,0,0
'"134125"','"ckanext-archiver"','"14"',0,0,0,'"884"','"Python"',20,4,24
'"134537"','"serengeti-pantry"','"26"',7,0,7,'"637"','"Ruby"',274,2,276
'"134768"','"babushka-deps"','"12"',16,0,16,'"1093"','"Ruby"',628,1,629
'"135818"','"rapidsms-ureport"','"11"',55,7,62,'"933"','"Python"',977,9,986
'"135898"','"collective.videoanysurfer"','"322"',0,0,0,'"616"','"Python"',50,0,50
'"135941"','"collective.portlet.videoanysurfer"','"322"',0,0,0,'"616"','"Python"',19,0,19
'"136190"','"rhoinstaller"','"20"',1,0,1,'"743"','"Ruby"',199,0,199
'"136220"','"ClearCaseUCMPlugin"','"12"',2,0,2,'"920"','"Java"',257,15,272
'"136276"','"ZopeSkel"','"322"',0,0,0,'"711"','"Python"',301,0,301
'"136293"','"bliss"','"10"',0,0,0,'"868"','"Python"',370,4,374
'"136544"','"foi-register"','"22"',4,1,5,'"741"','"Ruby"',402,14,416
'"136824"','"naaya-composer"','"14"',0,0,0,'"710"','"Python"',97,0,97
'"136846"','"nuxeo-marketplace-sample"','"22"',6,0,6,'"624"','"Java"',38,1,39
'"136944"','"cool"','"10"',4,1,5,'"1080"','"Java"',474,6,480
'"137013"','"artifactory-plugin"','"317"',0,2,2,'"1179"','"Java"',85,9,94
'"137134"','"lizard-geodin"','"15"',0,0,0,'"619"','"Python"',192,0,192
'"137149"','"buffet"','"26"',11,0,11,'"973"','"Ruby"',225,2,227
'"137404"','"koku-service-api"','"19"',0,0,0,'"708"','"Java"',296,0,296
'"137443"','"cucumber-jvm-fixtures"','"33"',4,0,4,'"636"','"Java"',304,1,305
'"137469"','"CanaryRecode"','"19"',0,0,0,'"627"','"Java"',642,29,671
'"137510"','"database"','"26"',1,4,5,'"722"','"Ruby"',31,60,91
'"137543"','"buddycloud-pusher"','"20"',5,0,5,'"576"','"Java"',52,1,53
'"137699"','"collective.portlet.ploneboard"','"12"',0,0,0,'"576"','"Python"',4,0,4
'"137758"','"CanaryLib"','"19"',0,0,0,'"627"','"Java"',644,23,667
'"137812"','"API"','"12"',0,0,0,'"594"','"Python"',354,0,354
'"137995"','"openstack-cloudaudit"','"10"',0,0,0,'"884"','"Python"',27,0,27
'"138100"','"json-log4j-layout"','"12"',0,0,0,'"1140"','"Java"',2,3,5
'"138238"','"beam"','"15"',237,0,237,'"1479"','"Java"',2991,5,2996
'"138333"','"com.idega.block.article"','"10"',6,0,6,'"1712"','"Java"',331,0,331
'"138368"','"com.idega.block.media"','"10"',1,0,1,'"1712"','"Java"',322,0,322
'"138386"','"com.idega.block.navigation"','"10"',1,0,1,'"1712"','"Java"',317,0,317
'"138404"','"wifiserver"','"15"',0,0,0,'"666"','"Java"',106,1,107
'"138427"','"com.idega.developer"','"10"',4,0,4,'"1712"','"Java"',321,0,321
'"138458"','"com.idega.graphics"','"10"',0,0,0,'"1712"','"Java"',175,0,175
'"138737"','"restarter.notify"','"12"',0,0,0,'"639"','"Python"',37,0,37
'"138838"','"GHANA-National"','"64"',0,0,0,'"931"','"Java"',619,0,619
'"139142"','"qmg-utilities"','"18"',0,0,0,'"1317"','"Java"',167,0,167
'"139160"','"wallmanager"','"14"',0,0,0,'"1476"','"Python"',213,0,213
'"139196"','"JPS"','"30"',1,0,1,'"1647"','"Java"',124,1,125
'"139447"','"nexus-ant-tasks"','"30"',0,0,0,'"625"','"Java"',117,13,130
'"139475"','"acts_presentably"','"10"',0,0,0,'"728"','"Ruby"',4,4,8
'"139496"','"socorro-toolbox"','"19"',4,0,4,'"846"','"Java"',19,8,27
'"139558"','"github-plugin"','"313"',1,3,4,'"1179"','"Java"',124,38,162
'"139679"','"lizard-screenshotter"','"15"',0,0,0,'"601"','"Python"',54,0,54
'"139692"','"vish"','"16"',284,0,284,'"784"','"Ruby"',2662,0,2662
'"140196"','"collective.prettydate"','"322"',0,0,0,'"774"','"Python"',76,1,77
'"140309"','"lizard-fewsjdbc"','"16"',13,3,16,'"661"','"Python"',241,5,246
'"140457"','"collective.geo.file"','"322"',0,0,0,'"717"','"Python"',21,0,21
'"140647"','"ftw.poodle"','"14"',16,2,18,'"826"','"Python"',217,12,229
'"140748"','"json-compare"','"14"',0,0,0,'"595"','"Ruby"',34,6,40
'"140863"','"basex-tests"','"12"',0,0,0,'"1058"','"Java"',233,12,245
'"140956"','"hbase-connector"','"103"',0,0,0,'"1052"','"Java"',87,1,88
'"140963"','"py-livefyre-client"','"42"',0,0,0,'"1014"','"Python"',9,2,11
'"141049"','"SimpleOAIHarvester"','"13"',0,0,0,'"836"','"Python"',21,0,21
'"141140"','"Zinc"','"19"',23,2,25,'"735"','"Python"',415,24,439
'"141159"','"SenchaBase"','"10"',6,0,6,'"609"','"Ruby"',180,0,180
'"141237"','"django-cron"','"12"',0,1,1,'"1120"','"Python"',73,13,86
'"141345"','"vagrant-django-template"','"13"',10,2,12,'"751"','"Python"',73,4,77
'"141358"','"ftw.table"','"14"',8,2,10,'"1077"','"Python"',516,24,540
'"141366"','"mule-module-jpa"','"100"',0,0,0,'"597"','"Java"',98,0,98
'"141737"','"tftp"','"29"',0,0,0,'"722"','"Ruby"',3,2,5
'"141790"','"naaya.content.talkback"','"14"',6,0,6,'"779"','"Python"',133,0,133
'"141793"','"chirpradio-webcontrol"','"12"',0,0,0,'"889"','"Python"',39,0,39
'"141927"','"rubyspec"','"39"',32,3,35,'"2104"','"Ruby"',6483,217,6700
'"141940"','"ufw"','"26"',0,0,0,'"722"','"Ruby"',14,10,24
'"142121"','"quality-measure-engine"','"10"',1,0,1,'"1240"','"Ruby"',112,12,124
'"142155"','"munin.zope"','"12"',0,0,0,'"737"','"Python"',61,6,67
'"142204"','"gradle-plugin"','"307"',0,0,0,'"1179"','"Java"',23,21,44
'"142225"','"community-plugins"','"13"',11,6,17,'"897"','"Java"',412,45,457
'"142238"','"blc-authorizenet"','"12"',17,0,17,'"577"','"Java"',100,1,101
'"142251"','"sensu-chef"','"15"',1,5,6,'"686"','"Ruby"',164,198,362
'"142306"','"blc-paypal"','"12"',27,0,27,'"577"','"Java"',92,3,95
'"142413"','"pinax-social"','"15"',0,0,0,'"689"','"Python"',23,0,23
'"142446"','"W3i-ReplicaIsland"','"42"',0,0,0,'"777"','"Java"',113,0,113
'"142524"','"global_session"','"80"',2,1,3,'"867"','"Ruby"',151,16,167
'"142527"','"titanium_desktop.ruble"','"84"',0,0,0,'"895"','"Ruby"',2,0,2
'"142564"','"perforce-plugin"','"317"',20,3,23,'"1179"','"Java"',170,40,210
'"142575"','"moin"','"15"',0,0,0,'"689"','"Python"',5,0,5
'"142683"','"scrapelib"','"15"',0,0,0,'"1339"','"Python"',271,4,275
'"142688"','"tornado-chat-mongo"','"15"',0,0,0,'"689"','"Python"',17,0,17
'"142813"','"pet-clinic"','"15"',0,0,0,'"682"','"Java"',26,0,26
'"143015"','"collective.pfg.soup"','"322"',0,0,0,'"590"','"Python"',58,0,58
'"143306"','"gae-continuous-deploy"','"12"',0,0,0,'"584"','"Python"',36,0,36
'"143327"','"translate"','"15"',0,0,0,'"1870"','"Ruby"',1,2,3
'"143729"','"clyde"','"16"',64,0,64,'"1051"','"Java"',631,4,635
'"143818"','"metlog-py"','"11"',0,0,0,'"875"','"Python"',292,27,319
'"144230"','"documentation"','"11"',12,1,13,'"687"','"Python"',379,19,398
'"144357"','"aeolus-configure"','"40"',0,0,0,'"878"','"Ruby"',343,21,364
'"144365"','"ems"','"13"',0,0,0,'"1724"','"Java"',71,1,72
'"144376"','"configliere"','"10"',1,0,1,'"1525"','"Ruby"',138,9,147
'"144429"','"openmrs-module-reporting"','"33"',89,12,101,'"625"','"Java"',622,73,695
'"144618"','"puppetlabs-nodejs"','"74"',1,5,6,'"700"','"Ruby"',18,51,69
'"144657"','"zamboni-lib"','"23"',1,1,2,'"1387"','"Python"',312,7,319
'"144889"','"seawolf5"','"14"',21,0,21,'"902"','"Python"',426,0,426
'"144976"','"rain-move"','"13"',0,0,0,'"696"','"Python"',146,0,146
'"145091"','"archetypes.referencebrowserwidget"','"236"',11,0,11,'"897"','"Python"',216,13,229
'"145347"','"valideer"','"11"',0,0,0,'"589"','"Python"',22,2,24
'"145553"','"not_system_ruby_cookbook"','"14"',0,0,0,'"651"','"Ruby"',6,3,9
'"145822"','"mapit"','"22"',15,2,17,'"1353"','"Python"',522,25,547
'"146731"','"cach3"','"21"',0,0,0,'"904"','"Java"',165,4,169
'"146799"','"plonetheme.sunburst"','"235"',11,1,12,'"893"','"Python"',379,13,392
'"146900"','"vayacondios"','"10"',100,2,102,'"1028"','"Ruby"',464,4,468
'"146912"','"collective.disqus"','"255"',1,0,1,'"725"','"Python"',114,7,121
'"147172"','"recurly-client-ruby"','"10"',20,7,27,'"1565"','"Ruby"',250,70,320
'"147391"','"css.ruble"','"16"',2,0,2,'"1528"','"Ruby"',73,0,73
'"147403"','"fascinator-shibboleth"','"12"',0,0,0,'"601"','"Java"',48,0,48
'"147408"','"what"','"15"',2,0,2,'"1031"','"Ruby"',87,6,93
'"147423"','"nenya"','"16"',3,0,3,'"1065"','"Java"',321,1,322
'"147808"','"jiffy_enums"','"29"',0,0,0,'"575"','"Ruby"',51,5,56
'"149025"','"stepsovc-motech"','"57"',0,0,0,'"708"','"Java"',260,0,260
'"149212"','"sdes-stscripts"','"10"',0,0,0,'"896"','"Python"',204,0,204
'"149646"','"svn-tag-plugin"','"307"',0,2,2,'"1179"','"Java"',127,4,131
'"150461"','"mqtt-client"','"22"',19,2,21,'"810"','"Java"',70,4,74
'"150631"','"connection_pool_scaffold"','"11"',1,2,3,'"1106"','"Java"',5,7,12
'"150834"','"org.ops4j.pax.logging"','"66"',5,1,6,'"1182"','"Java"',324,10,334
'"151238"','"cookbooks_opensource"','"89"',0,0,0,'"1372"','"Ruby"',24,0,24
'"151311"','"rack_session_access"','"43"',0,0,0,'"789"','"Ruby"',11,3,14
'"151343"','"flooding-worker"','"15"',0,0,0,'"633"','"Python"',188,0,188
'"151558"','"q7examples"','"18"',0,0,0,'"828"','"Java"',74,0,74
'"151727"','"ci-game-plugin"','"307"',0,0,0,'"1178"','"Java"',206,10,216
'"151835"','"django-oscar-paymentexpress"','"14"',0,0,0,'"574"','"Python"',16,4,20
'"151875"','"activity_feed"','"19"',1,0,1,'"905"','"Ruby"',104,15,119
'"152018"','"goliath-contrib"','"16"',0,0,0,'"663"','"Ruby"',18,5,23
'"152025"','"geoserver-manager"','"11"',4,2,6,'"1033"','"Java"',192,53,245
'"152424"','"ftw.favorite"','"14"',0,0,0,'"826"','"Python"',51,1,52
'"152440"','"jira-multi-level-cascade-select"','"17"',0,0,0,'"1178"','"Java"',77,1,78
'"152604"','"pycaption"','"53"',11,9,20,'"643"','"Python"',71,22,93
'"152649"','"volumina"','"21"',32,1,33,'"975"','"Python"',808,21,829
'"152765"','"collective.captionmanager"','"322"',0,0,0,'"588"','"Python"',6,0,6
'"152861"','"plone.dexterity"','"236"',8,0,8,'"898"','"Python"',117,16,133
'"152865"','"plone.app.stagingbehavior"','"236"',1,0,1,'"898"','"Python"',20,5,25
'"152921"','"plone.app.dexterity"','"234"',24,6,30,'"898"','"Python"',238,42,280
'"153007"','"simple_assertions"','"10"',0,0,0,'"862"','"Ruby"',48,1,49
'"153093"','"mbutil"','"19"',3,4,7,'"1116"','"Python"',23,18,41
'"153234"','"packnga"','"15"',0,0,0,'"939"','"Ruby"',336,1,337
'"153290"','"python-googlegeocoder"','"10"',0,0,0,'"933"','"Python"',42,3,45
'"153349"','"django-haikus"','"14"',0,0,0,'"751"','"Python"',92,0,92
'"153484"','"seleniumhtmlreport"','"317"',0,0,0,'"1151"','"Java"',0,1,1
'"153487"','"ServiceOAuth"','"22"',0,0,0,'"765"','"Ruby"',1,0,1
'"153518"','"jarn.mkrelease"','"13"',0,0,0,'"925"','"Python"',349,0,349
'"153604"','"inventory"','"15"',4,0,4,'"868"','"Java"',58,0,58
'"153935"','"jclouds-abiquo"','"29"',0,0,0,'"886"','"Java"',404,0,404
'"153944"','"cpf"','"12"',8,8,16,'"730"','"Java"',471,14,485
'"154120"','"emas.buildout"','"13"',21,0,21,'"804"','"Python"',438,0,438
'"154145"','"sheriff"','"16"',0,0,0,'"1378"','"Ruby"',328,1,329
'"154208"','"licence-finder"','"90"',14,7,21,'"679"','"Ruby"',500,53,553
'"154882"','"internal.isfit.org"','"12"',62,6,68,'"977"','"Ruby"',652,11,663
'"154956"','"straitjacket"','"13"',0,0,0,'"906"','"Python"',10,2,12
'"154961"','"codewarden"','"13"',0,0,0,'"906"','"Python"',2,1,3
'"155381"','"jasy"','"10"',0,0,0,'"1086"','"Python"',2415,60,2475
'"155512"','"kumade"','"48"',0,0,0,'"947"','"Ruby"',434,56,490
'"155751"','"rroonga"','"15"',61,1,62,'"1416"','"Ruby"',874,11,885
'"155958"','"collective.localrolesdatatables"','"322"',0,0,0,'"678"','"Python"',56,1,57
'"156045"','"spice-zapper"','"31"',0,0,0,'"679"','"Java"',43,1,44
'"156467"','"right_agent"','"75"',94,12,106,'"1010"','"Ruby"',557,103,660
'"156699"','"jfxtras-labs"','"16"',33,6,39,'"752"','"Java"',599,56,655
'"156817"','"cartodb-python"','"14"',2,1,3,'"1053"','"Python"',34,3,37
'"156982"','"iproto-ruby"','"41"',8,0,8,'"773"','"Ruby"',52,2,54
'"157255"','"excelinator"','"79"',0,1,1,'"597"','"Ruby"',4,2,6
'"157406"','"bwoken"','"13"',0,0,0,'"713"','"Ruby"',68,22,90
'"157457"','"java-ee-commons"','"11"',0,0,0,'"575"','"Java"',13,0,13
'"157546"','"Origami"','"48"',8,1,9,'"623"','"Python"',58,18,76
'"157898"','"simple-rest-server"','"11"',0,0,0,'"575"','"Java"',14,0,14
'"158057"','"cassandra_object"','"13"',46,3,49,'"1182"','"Ruby"',335,24,359
'"158071"','"release"','"11"',10,11,21,'"1011"','"Java"',198,336,534
'"158212"','"engineyard-serverside"','"11"',1,1,2,'"1301"','"Ruby"',550,61,611
'"158285"','"cucumber-rails-training-wheels"','"16"',0,0,0,'"883"','"Ruby"',1,0,1
'"158322"','"jewas"','"13"',0,0,0,'"967"','"Java"',301,0,301
'"158795"','"loom-java"','"16"',0,0,0,'"786"','"Java"',61,6,67
'"159178"','"sass-maven-plugin"','"17"',3,1,4,'"675"','"Java"',38,32,70
'"159350"','"dataloader"','"19"',0,0,0,'"1218"','"Java"',193,29,222
'"159720"','"hastur"','"22"',0,0,0,'"633"','"Ruby"',9,0,9
'"159916"','"puppetlabs-corosync"','"75"',2,2,4,'"722"','"Ruby"',29,50,79
'"159975"','"taskmapper-kanbanpad"','"24"',0,0,0,'"1216"','"Ruby"',250,6,256
'"160328"','"splunk-app-twitter"','"16"',0,0,0,'"637"','"Python"',30,3,33
'"160501"','"braintree_java"','"24"',3,0,3,'"1472"','"Java"',59,2,61
'"160532"','"couchbase-java-client"','"49"',21,0,21,'"835"','"Java"',281,2,283
'"160704"','"chef-varnish"','"58"',0,2,2,'"591"','"Ruby"',43,11,54
'"160833"','"twofishes"','"34"',43,4,47,'"748"','"Java"',939,16,955
'"160896"','"icalendar"','"320"',2,2,4,'"932"','"Python"',182,47,229
'"161016"','"eventfulapi"','"12"',0,0,0,'"989"','"Ruby"',4,0,4
'"161036"','"neat"','"50"',10,6,16,'"581"','"Ruby"',307,54,361
'"161140"','"cookbooks_internal"','"35"',27,0,27,'"1157"','"Ruby"',1224,2,1226
'"161155"','"jar2xml"','"46"',1,0,1,'"1009"','"Java"',146,1,147
'"161254"','"collective.cover"','"420"',30,3,33,'"871"','"Python"',1628,136,1764
'"161493"','"chef-xhprof-gui"','"55"',0,0,0,'"602"','"Ruby"',29,2,31
'"161547"','"TileExpire"','"15"',0,0,0,'"594"','"Python"',19,0,19
'"161627"','"ncs_navigator_deployment"','"10"',0,0,0,'"657"','"Ruby"',522,1,523
'"161638"','"amazon_seller_central"','"12"',0,0,0,'"978"','"Ruby"',104,8,112
'"161684"','"plone.app.querystring"','"230"',6,2,8,'"899"','"Python"',96,20,116
'"162131"','"HttpService"','"13"',0,0,0,'"1190"','"Java"',32,0,32
'"162140"','"RESTProvider"','"14"',0,0,0,'"1613"','"Java"',0,1,1
'"162259"','"bv-android-sdk"','"42"',0,0,0,'"654"','"Java"',98,8,106
'"162451"','"ical_importer"','"44"',0,0,0,'"575"','"Ruby"',101,7,108
'"162539"','"wouso"','"11"',33,7,40,'"815"','"Python"',1657,137,1794
'"162641"','"vim"','"26"',0,1,1,'"722"','"Ruby"',8,7,15
'"162735"','"vend-ruby"','"10"',0,0,0,'"757"','"Ruby"',70,1,71
'"162744"','"simhash-cluster"','"65"',0,0,0,'"625"','"Python"',6,1,7
'"162951"','"sitenow_standardtheme"','"11"',0,0,0,'"633"','"Ruby"',129,0,129
'"162964"','"aichallenge"','"14"',0,0,0,'"1124"','"Python"',2386,133,2519
'"163173"','"CalendarPortlet"','"17"',10,2,12,'"722"','"Java"',52,21,73
'"163214"','"django-on-dotcloud"','"14"',0,0,0,'"695"','"Python"',5,2,7
'"163358"','"kyoto"','"19"',0,0,0,'"647"','"Java"',362,0,362
'"163362"','"nsisam-ruby"','"19"',0,0,0,'"756"','"Ruby"',150,0,150
'"163394"','"testengineer"','"13"',0,0,0,'"688"','"Ruby"',14,2,16
'"163853"','"SQLiteProvider"','"14"',28,6,34,'"1209"','"Java"',89,13,102
'"164085"','"wrest"','"18"',0,0,0,'"1934"','"Ruby"',209,8,217
'"164163"','"components-ness-jersey"','"15"',0,0,0,'"666"','"Java"',66,13,79
'"164170"','"socialcast-command-line"','"29"',24,0,24,'"1364"','"Ruby"',168,21,189
'"164194"','"heroku.jar"','"13"',0,0,0,'"871"','"Java"',173,20,193
'"164285"','"ella-galleries"','"11"',0,0,0,'"765"','"Python"',53,6,59
'"164310"','"git-server-plugin"','"317"',4,2,6,'"574"','"Java"',20,3,23
'"164325"','"trigger"','"15"',0,0,0,'"737"','"Python"',192,25,217
'"164355"','"bazaar-plugin"','"319"',0,0,0,'"1179"','"Java"',158,9,167
'"164600"','"collective.diazo.readheaders"','"322"',0,0,0,'"575"','"Python"',7,0,7
'"164974"','"testables"','"11"',0,0,0,'"664"','"Ruby"',85,0,85
'"165020"','"world_bank_ruby"','"22"',0,0,0,'"994"','"Ruby"',2,2,4
'"165081"','"openmrs-module-htmlwidgets"','"34"',3,2,5,'"626"','"Java"',35,3,38
'"165155"','"AndroidIntelliJStarter"','"22"',0,0,0,'"946"','"Java"',37,7,44
'"165427"','"xija"','"10"',9,2,11,'"1030"','"Python"',188,9,197
'"165517"','"amico"','"19"',1,0,1,'"785"','"Ruby"',57,11,68
'"165640"','"django-basic-models"','"13"',0,0,0,'"864"','"Python"',26,18,44
'"166004"','"spree_product_zoom"','"31"',2,2,4,'"595"','"Ruby"',41,14,55
'"166871"','"cismap-plugin"','"12"',7,0,7,'"574"','"Java"',334,0,334
'"166873"','"cids-navigator"','"12"',10,0,10,'"574"','"Java"',539,0,539
'"167184"','"zkthemes"','"17"',2,0,2,'"671"','"Java"',280,12,292
'"167361"','"flow-cytometry"','"11"',19,0,19,'"658"','"Java"',131,0,131
'"167396"','"typhoid"','"42"',0,0,0,'"630"','"Ruby"',42,13,55
'"167666"','"openssh"','"26"',0,2,2,'"722"','"Ruby"',46,36,82
'"167915"','"oq-ui-geoserver"','"15"',0,0,0,'"757"','"Python"',67,16,83
'"168008"','"ghana-national-regression"','"57"',0,0,0,'"667"','"Java"',109,0,109
'"168215"','"plone.app.contenttypes"','"236"',150,13,163,'"850"','"Python"',606,49,655
'"168427"','"Products.CMFDiffTool"','"236"',0,0,0,'"838"','"Python"',152,0,152
'"168444"','"rm-plugin"','"11"',0,0,0,'"574"','"Java"',23,0,23
'"168728"','"wiki-tests"','"30"',1,1,2,'"961"','"Python"',57,43,100
'"168761"','"pusher-gem"','"10"',0,0,0,'"1491"','"Ruby"',219,22,241
'"168816"','"cookbooks"','"22"',0,0,0,'"746"','"Ruby"',24,0,24
'"168861"','"nuts-and-bolts"','"50"',8,1,9,'"1288"','"Java"',266,8,274
'"168886"','"flooding-lib"','"15"',42,0,42,'"636"','"Python"',703,5,708
'"169041"','"travis-weblint"','"39"',0,0,0,'"747"','"Ruby"',55,9,64
'"169122"','"puppetlabs-f5"','"73"',0,0,0,'"960"','"Ruby"',237,98,335
'"169125"','"sisu-task-scheduler"','"29"',0,0,0,'"1059"','"Java"',132,8,140
'"169186"','"powder"','"10"',3,4,7,'"1063"','"Ruby"',47,67,114
'"169222"','"modeler"','"32"',0,0,0,'"916"','"Java"',81,44,125
'"169251"','"PyVEP"','"24"',0,0,0,'"834"','"Python"',11,4,15
'"169410"','"input-tests"','"47"',1,1,2,'"1192"','"Python"',210,149,359
'"169529"','"website"','"10"',23,0,23,'"760"','"Python"',577,10,587
'"169549"','"nuggets"','"23"',0,1,1,'"1282"','"Python"',25,3,28
'"169719"','"downpour"','"65"',0,0,0,'"849"','"Python"',150,7,157
'"169744"','"collective.folderishtypes"','"322"',0,0,0,'"1265"','"Python"',122,0,122
'"169847"','"guides"','"29"',5,2,7,'"1045"','"Ruby"',272,66,338
'"169902"','"hexagonit.themeskel"','"10"',1,0,1,'"903"','"Python"',245,0,245
'"169932"','"rackspace-monitoring-cli"','"130"',9,8,17,'"816"','"Python"',205,34,239
'"170024"','"provisioning-portal"','"17"',0,0,0,'"749"','"Java"',95,0,95
'"170122"','"dawn-third"','"12"',19,0,19,'"779"','"Java"',140,0,140
'"170224"','"maws"','"16"',0,0,0,'"836"','"Ruby"',231,4,235
'"170252"','"ruby-runtime-plugin"','"307"',0,1,1,'"944"','"Java"',4,3,7
'"170264"','"configman"','"11"',2,1,3,'"837"','"Python"',104,79,183
'"170270"','"firefox-flicks"','"11"',0,1,1,'"786"','"Python"',495,268,763
'"170419"','"parameterized-trigger-plugin"','"307"',2,2,4,'"1179"','"Java"',65,62,127
'"170425"','"encore"','"55"',12,6,18,'"818"','"Python"',198,64,262
'"170434"','"appsync"','"23"',0,0,0,'"876"','"Python"',42,6,48
'"170802"','"plone.app.workflowmanager"','"236"',16,1,17,'"837"','"Python"',57,14,71
'"172825"','"trade-tariff-backend"','"113"',121,14,135,'"661"','"Ruby"',1889,143,2032
'"172970"','"rest-poc"','"76"',0,0,0,'"573"','"Java"',68,0,68
'"173207"','"sumo-tests"','"40"',5,4,9,'"1044"','"Python"',336,219,555
'"175693"','"pjeuler"','"19"',0,0,0,'"570"','"Ruby"',540,5,545
'"177259"','"tabris-demos"','"12"',9,0,9,'"770"','"Java"',208,0,208
'"177333"','"journey"','"20"',2,2,4,'"917"','"Ruby"',90,39,129
'"177545"','"tidbits"','"10"',1,1,2,'"1835"','"Ruby"',81,1,82
'"177763"','"templates-set"','"23"',0,0,0,'"1053"','"Java"',307,0,307
'"177892"','"ldap-connector"','"98"',0,0,0,'"767"','"Java"',72,1,73
'"178035"','"commons-amqp"','"27"',8,3,11,'"899"','"Java"',292,10,302
'"181229"','"matplotlib.github.com"','"14"',0,0,0,'"1111"','"Python"',77,3,80
'"181295"','"rosrs-sms"','"24"',0,0,0,'"868"','"Java"',118,0,118
'"181371"','"rosrs-dlibra"','"25"',0,0,0,'"869"','"Java"',82,0,82
'"184142"','"mercurial-plugin"','"298"',20,9,29,'"1179"','"Java"',227,55,282
'"185306"','"Computational-Sensing-Research"','"12"',0,0,0,'"597"','"Java"',27,0,27
'"185366"','"smokey"','"101"',35,10,45,'"841"','"Ruby"',539,67,606
'"185560"','"linkedin-connector"','"83"',0,0,0,'"924"','"Java"',66,0,66
'"187196"','"plone.app.search"','"233"',7,2,9,'"898"','"Python"',342,10,352
'"187488"','"radiociblog"','"10"',2,1,3,'"809"','"Python"',213,1,214
'"188939"','"FTBLaunch"','"14"',70,33,103,'"573"','"Java"',386,194,580
'"189752"','"muddle"','"11"',0,0,0,'"714"','"Ruby"',137,15,152
'"190783"','"trade-tariff-frontend"','"97"',26,13,39,'"661"','"Ruby"',1234,117,1351
'"191064"','"show_for"','"18"',5,0,5,'"1542"','"Ruby"',92,33,125
'"192264"','"DIRACDocs"','"22"',1,2,3,'"1051"','"Python"',200,27,227
'"192534"','"deform"','"20"',3,5,8,'"1114"','"Python"',670,139,809
'"193366"','"subrails"','"34"',0,0,0,'"870"','"Ruby"',18,1,19
'"194056"','"VMDIRAC"','"22"',4,9,13,'"863"','"Python"',198,50,248
'"194359"','"nrml"','"13"',0,0,0,'"812"','"Python"',317,72,389
'"194877"','"Medmon"','"10"',0,0,0,'"1074"','"Java"',322,19,341
'"195656"','"ceres"','"11"',29,0,29,'"1479"','"Java"',1153,3,1156
'"196147"','"hydra-head"','"22"',54,17,71,'"1091"','"Ruby"',1155,110,1265
'"197275"','"mailer-plugin"','"295"',3,3,6,'"570"','"Java"',35,12,47
'"197824"','"sonar-php"','"27"',208,0,208,'"640"','"Java"',494,0,494
'"198021"','"Multicorn"','"15"',34,2,36,'"1005"','"Python"',504,18,522
'"198693"','"confluence-nexus-plugin"','"24"',0,0,0,'"785"','"Java"',46,13,59
'"198973"','"taskmapper-github"','"23"',0,0,0,'"1337"','"Ruby"',161,4,165
'"201224"','"traitsui"','"74"',13,7,20,'"1053"','"Python"',1045,106,1151
'"202365"','"appraisal"','"65"',20,0,20,'"1211"','"Ruby"',286,36,322
'"202844"','"turbo_bridge"','"10"',0,0,0,'"573"','"Ruby"',9,0,9
'"203397"','"briar-patch"','"11"',0,0,0,'"786"','"Python"',113,4,117
'"203460"','"dawn-tango"','"12"',9,0,9,'"779"','"Java"',93,2,95
'"203644"','"Products.BrFieldsAndWidgets"','"323"',0,0,0,'"811"','"Python"',56,0,56
'"203694"','"sc.pfg.brazilianfields"','"323"',0,0,0,'"811"','"Python"',66,1,67
'"204403"','"whatdotheyknow-theme"','"22"',26,3,29,'"996"','"Ruby"',374,30,404
'"204652"','"nexus-migration-plugin"','"28"',0,0,0,'"1044"','"Java"',124,6,130
'"205356"','"FP"','"12"',0,0,0,'"617"','"Python"',60,0,60
'"206096"','"recurly-client-python"','"16"',5,4,9,'"1475"','"Python"',114,33,147
'"206926"','"pressley"','"13"',0,0,0,'"657"','"Python"',39,0,39
'"206935"','"Capitol-Words"','"15"',2,1,3,'"1326"','"Python"',332,2,334
'"206971"','"python-transparencydata"','"16"',1,0,1,'"1430"','"Python"',74,1,75
'"206982"','"calloncongress"','"15"',0,0,0,'"695"','"Python"',224,0,224
'"208082"','"rhaptos2.common"','"19"',0,0,0,'"615"','"Python"',63,5,68
'"208145"','"reppy"','"58"',5,1,6,'"859"','"Python"',63,8,71
'"208181"','"rubyperu.github.com"','"13"',1,0,1,'"868"','"Ruby"',91,4,95
'"208674"','"nuxeo-platform-login"','"22"',16,0,16,'"812"','"Java"',380,6,386
'"209250"','"mozillians-tests"','"42"',13,15,28,'"888"','"Python"',142,113,255
'"210280"','"sauce-java"','"10"',15,4,19,'"631"','"Java"',122,4,126
'"210480"','"aramis-build-toolkit"','"13"',0,0,0,'"884"','"Java"',54,4,58
'"210512"','"chanko"','"61"',2,1,3,'"806"','"Ruby"',130,34,164
'"211549"','"freeseer"','"23"',67,34,101,'"1556"','"Python"',2570,147,2717
'"211648"','"klomp"','"74"',0,0,0,'"636"','"Ruby"',60,1,61
'"211653"','"haystack-cloudsearch"','"49"',0,0,0,'"573"','"Python"',42,1,43
'"212507"','"jgroups-aws"','"45"',0,0,0,'"619"','"Java"',74,1,75
'"212755"','"sqlaload"','"12"',0,1,1,'"805"','"Python"',24,4,28
'"213686"','"active_hash"','"21"',12,5,17,'"1688"','"Ruby"',179,34,213
'"213856"','"git-scripts"','"20"',27,7,34,'"776"','"Ruby"',490,78,568
'"214821"','"OTPSetup"','"20"',0,0,0,'"842"','"Python"',166,0,166
'"215686"','"mmoChat"','"12"',0,0,0,'"926"','"Java"',78,3,81
'"215715"','"mmoCore"','"12"',0,0,0,'"929"','"Java"',98,5,103
'"216699"','"http-testing-harness"','"28"',0,0,0,'"1200"','"Java"',242,2,244
'"216815"','"openmrs-module-basicmodule"','"33"',0,0,0,'"596"','"Java"',35,2,37
'"218083"','"org.pm4j"','"11"',82,1,83,'"788"','"Java"',764,2,766
'"218181"','"ome-documentation"','"41"',86,84,170,'"779"','"Python"',1479,688,2167
'"219631"','"integrity-plugin"','"296"',12,2,14,'"1101"','"Java"',106,5,111
'"220422"','"warble"','"12"',0,0,0,'"1088"','"Ruby"',257,12,269
'"221033"','"ZenPacks.zenoss.CloudStack"','"22"',0,0,0,'"868"','"Python"',119,4,123
'"222033"','"softwaremill-common"','"14"',0,0,0,'"1331"','"Java"',337,2,339
'"223316"','"fozzie"','"26"',0,0,0,'"817"','"Ruby"',132,13,145
'"223846"','"pyface"','"68"',3,3,6,'"1053"','"Python"',299,81,380
'"224186"','"join-plugin"','"298"',0,0,0,'"1179"','"Java"',118,6,124
'"227579"','"apache-whirr"','"18"',0,0,0,'"645"','"Java"',22,0,22
'"227912"','"travis-lint"','"21"',1,1,2,'"756"','"Ruby"',60,27,87
'"230023"','"rhaptos.cnxmlutils"','"18"',0,0,0,'"822"','"Python"',450,41,491
'"230840"','"rap-virgo-examples"','"18"',0,0,0,'"611"','"Java"',28,0,28
'"230938"','"analysis-core-plugin"','"301"',12,0,12,'"1179"','"Java"',200,20,220
'"230968"','"genpy"','"12"',9,2,11,'"845"','"Python"',187,18,205
'"231370"','"moztrap-tests"','"42"',5,5,10,'"904"','"Python"',173,120,293
'"232051"','"webdev-bootcamp"','"21"',1,4,5,'"1036"','"Python"',78,31,109
'"232089"','"timestamper-plugin"','"316"',1,3,4,'"1179"','"Java"',140,7,147
'"232705"','"knife-windows"','"60"',7,9,16,'"1098"','"Ruby"',128,68,196
'"232818"','"right_amqp"','"89"',3,2,5,'"773"','"Ruby"',81,20,101
'"234252"','"PyBrowserID"','"22"',0,0,0,'"722"','"Python"',106,16,122
'"234674"','"plone.app.upgrade"','"149"',50,2,52,'"893"','"Python"',288,16,304
'"235039"','"bluekai_middleware"','"27"',12,2,14,'"666"','"Ruby"',97,14,111
'"235124"','"Plone"','"149"',3,0,3,'"893"','"Python"',79,0,79
'"237770"','"roku-client-public"','"16"',5,1,6,'"924"','"Python"',250,24,274
'"238449"','"oq-eqcatalogue-tool"','"13"',0,0,0,'"734"','"Python"',260,43,303
'"239066"','"ticket_sharing"','"88"',0,0,0,'"1059"','"Ruby"',156,15,171
'"241535"','"e2openplugin-ShootYourScreen"','"18"',0,0,0,'"886"','"Python"',4,1,5
'"241678"','"automaticruby"','"12"',32,0,32,'"746"','"Ruby"',263,22,285
'"242675"','"Xebium"','"92"',9,1,10,'"1239"','"Java"',154,18,172
'"246637"','"socorro-crashstats"','"18"',0,0,0,'"664"','"Python"',386,405,791
'"246667"','"tapp"','"39"',0,1,1,'"1338"','"Ruby"',56,11,67
'"247032"','"glimpse"','"11"',19,0,19,'"728"','"Java"',171,1,172
'"247104"','"ftp9"','"12"',0,0,0,'"611"','"Python"',19,0,19
'"247810"','"schoolselection"','"49"',0,0,0,'"938"','"Ruby"',98,0,98
'"247891"','"maven-mule-plugin"','"82"',0,0,0,'"1021"','"Java"',68,2,70
'"248477"','"DRISEE"','"12"',0,0,0,'"912"','"Python"',129,7,136
'"250613"','"chef-couchbase"','"14"',0,0,0,'"665"','"Ruby"',3,4,7
'"252194"','"jubatus-java-client"','"14"',6,4,10,'"692"','"Java"',84,18,102
'"252680"','"aerogear-android"','"13"',77,9,86,'"605"','"Java"',802,139,941
'"253596"','"droolsjbpm-tools"','"37"',12,1,13,'"1120"','"Java"',422,30,452
'"254189"','"zookeeper"','"84"',0,0,0,'"951"','"Java"',28,0,28
'"254628"','"xdtuxbot"','"24"',0,0,0,'"1102"','"Python"',42,0,42
'"254745"','"lascivious"','"13"',0,0,0,'"903"','"Ruby"',39,1,40
'"254823"','"RESTData"','"11"',0,0,0,'"657"','"Java"',21,0,21
'"254955"','"jubatus-ruby-client"','"14"',4,1,5,'"668"','"Ruby"',58,13,71
'"255649"','"gae-sample4exo-ide"','"15"',0,0,0,'"631"','"Java"',1,0,1
'"256086"','"bitcoin.org"','"10"',114,28,142,'"918"','"Ruby"',1243,250,1493
'"257298"','"datcom2modelica"','"11"',0,0,0,'"600"','"Python"',28,0,28
'"257425"','"chef-magento"','"57"',9,6,15,'"598"','"Ruby"',168,54,222
'"260518"','"adaptly_pi"','"23"',0,0,0,'"730"','"Ruby"',44,4,48
'"261032"','"colonial_raptor"','"12"',0,0,0,'"884"','"Ruby"',78,5,83
'"261125"','"Xcodeproj"','"31"',12,2,14,'"850"','"Ruby"',433,53,486
'"261531"','"importtools"','"10"',0,0,0,'"727"','"Python"',153,2,155
'"262371"','"gatein-api-java"','"15"',0,0,0,'"936"','"Java"',220,8,228
'"263895"','"slices"','"18"',0,0,0,'"632"','"Python"',85,1,86
'"265303"','"gedcomx-rs"','"10"',0,0,0,'"721"','"Java"',279,1,280
'"265972"','"django-photoprocessor"','"12"',0,0,0,'"877"','"Python"',37,0,37
'"266617"','"nexus-p2-repository-plugin"','"31"',0,0,0,'"1004"','"Java"',148,28,176
'"268394"','"Code-Standards"','"12"',0,0,0,'"750"','"Java"',9,0,9
'"268561"','"subversion"','"26"',0,0,0,'"722"','"Ruby"',22,7,29
'"269532"','"plone.app.collection"','"234"',8,1,9,'"893"','"Python"',451,19,470
'"270016"','"radar_parlamentar"','"17"',18,3,21,'"818"','"Python"',582,28,610
'"270784"','"travis-support"','"39"',3,0,3,'"828"','"Ruby"',258,11,269
'"274828"','"console_util"','"10"',0,0,0,'"1051"','"Ruby"',17,2,19
'"274836"','"email-ext-plugin"','"311"',37,4,41,'"1179"','"Java"',299,84,383
'"274879"','"cwru-ros-pkg"','"11"',0,0,0,'"1255"','"Python"',264,1,265
'"275789"','"planet.plone.org"','"150"',2,0,2,'"881"','"Python"',136,35,171
'"276197"','"cloudmine-android"','"15"',0,0,0,'"871"','"Java"',125,10,135
'"277125"','"redu.github.com"','"14"',0,0,0,'"734"','"Ruby"',103,6,109
'"278099"','"crypto"','"12"',18,0,18,'"938"','"Java"',773,3,776
'"279911"','"TAMA-Web"','"61"',0,0,0,'"993"','"Java"',759,0,759
'"281516"','"OpenConext-teams"','"11"',3,0,3,'"723"','"Java"',294,1,295
'"281872"','"Products.PloneOrg"','"230"',0,0,0,'"889"','"Python"',342,12,354
'"281877"','"pm-dashboard"','"13"',0,0,0,'"953"','"Ruby"',261,0,261
'"283611"','"com.idega.block.form"','"10"',10,0,10,'"1688"','"Java"',142,0,142
'"285318"','"foreman-export-nature"','"10"',0,0,0,'"780"','"Ruby"',52,5,57
'"285528"','"plone.formwidget.multifile"','"149"',0,0,0,'"899"','"Python"',53,5,58
'"285763"','"unfolding"','"12"',48,0,48,'"695"','"Java"',783,5,788
'"285905"','"ki_youtrack"','"23"',0,0,0,'"570"','"Ruby"',59,2,61
'"287423"','"gmaps-coordinates-helper"','"16"',0,0,0,'"609"','"Ruby"',3,1,4
'"287617"','"sisu-velocity"','"29"',0,0,0,'"639"','"Java"',13,1,14
'"287975"','"TestCenter"','"12"',0,0,0,'"644"','"Java"',303,0,303
'"288440"','"EFG"','"101"',94,16,110,'"660"','"Ruby"',2558,195,2753
'"288738"','"bamboo"','"19"',0,0,0,'"631"','"Python"',161,15,176
'"289481"','"git-practice"','"10"',0,0,0,'"714"','"Python"',54,5,59
'"289533"','"collective.perseo"','"12"',0,0,0,'"616"','"Python"',230,1,231
'"289547"','"OpenConext-api"','"11"',4,0,4,'"721"','"Java"',242,1,243
'"289935"','"Californium"','"10"',22,1,23,'"1088"','"Java"',761,20,781
'"290522"','"collective.masonry"','"256"',0,0,0,'"1106"','"Python"',31,0,31
'"290669"','"dawn-mx"','"12"',2,0,2,'"618"','"Java"',33,0,33
'"290829"','"cloudkey-py"','"26"',1,0,1,'"1474"','"Python"',98,1,99
'"291425"','"starteam-plugin"','"301"',10,1,11,'"1179"','"Java"',315,9,324
'"291540"','"oerpub.rhaptoslabs.sword2cnx"','"16"',0,0,0,'"885"','"Python"',23,0,23
'"291665"','"ki_pivotal"','"23"',0,0,0,'"570"','"Ruby"',79,2,81
'"292686"','"contact-o-tron"','"70"',0,0,0,'"849"','"Ruby"',97,0,97
'"292891"','"design-principles"','"117"',78,29,107,'"720"','"Ruby"',1106,145,1251
'"293407"','"ckanext-dgu"','"13"',0,0,0,'"826"','"Python"',301,0,301
'"293531"','"http_logger"','"40"',0,0,0,'"1034"','"Ruby"',50,5,55
'"293725"','"python-omgeo"','"17"',0,0,0,'"727"','"Python"',191,5,196
'"294678"','"ftw.notification.base"','"14"',8,2,10,'"826"','"Python"',175,9,184
'"295767"','"tranSMART-ETL"','"12"',0,0,0,'"616"','"Java"',61,3,64
'"295815"','"casexml"','"19"',229,43,272,'"1009"','"Python"',1166,191,1357
'"295915"','"plone.app.async"','"149"',0,0,0,'"837"','"Python"',78,3,81
'"296456"','"playmodutils"','"38"',0,0,0,'"609"','"Java"',72,8,80
'"296788"','"right_http_connection"','"88"',1,1,2,'"1723"','"Ruby"',129,19,148
'"296919"','"restarter.buildout"','"12"',0,0,0,'"640"','"Python"',84,0,84
'"297256"','"zojax.personal.project"','"15"',1,0,1,'"971"','"Python"',9,0,9
'"297314"','"zojax.security"','"15"',0,0,0,'"972"','"Python"',10,0,10
'"298346"','"kStrano"','"15"',7,2,9,'"847"','"Ruby"',229,18,247
'"298870"','"sentry"','"26"',0,0,0,'"570"','"Python"',80,8,88
'"301065"','"IslandoraPYUtils"','"26"',1,2,3,'"1035"','"Python"',254,28,282
'"301446"','"kharcha"','"11"',0,0,0,'"741"','"Python"',59,0,59
'"302389"','"coaster"','"10"',9,0,9,'"827"','"Python"',235,10,245
'"302528"','"feeder"','"10"',0,0,0,'"733"','"Ruby"',341,6,347
'"302573"','"sched-assist"','"16"',0,0,0,'"722"','"Java"',55,1,56
'"302672"','"dtkit-plugin"','"295"',0,0,0,'"902"','"Java"',52,2,54
'"303451"','"smidig-conference"','"12"',0,0,0,'"1428"','"Ruby"',305,3,308
'"304480"','"conan"','"30"',0,0,0,'"1185"','"Ruby"',91,1,92
'"304658"','"django-marimo"','"33"',0,0,0,'"869"','"Python"',80,0,80
'"305608"','"kitchensink-ear"','"15"',0,0,0,'"576"','"Java"',4,0,4
'"306220"','"ims-lti"','"10"',1,1,2,'"730"','"Ruby"',35,7,42
'"306230"','"yammer-connector"','"83"',0,0,0,'"1050"','"Java"',83,0,83
'"306638"','"dimagi-utils"','"19"',17,7,24,'"1273"','"Python"',727,180,907
'"306987"','"iron_cache_ruby"','"10"',5,0,5,'"716"','"Ruby"',89,19,108
'"307422"','"jbpm-console-ng"','"36"',91,2,93,'"570"','"Java"',731,64,795
'"307507"','"jbpm-editors-port"','"36"',0,0,0,'"570"','"Java"',6,0,6
'"307772"','"webintents-agent"','"15"',0,0,0,'"666"','"Java"',37,0,37
'"307810"','"VooDooDriver"','"108"',6,0,6,'"958"','"Java"',437,2,439
'"308105"','"email-preview"','"17"',7,0,7,'"722"','"Java"',113,52,165
'"308842"','"source.ruble"','"15"',2,0,2,'"1505"','"Ruby"',104,1,105
'"309217"','"plone.app.relationfield"','"234"',1,1,2,'"898"','"Python"',92,5,97
'"309466"','"bento"','"62"',22,24,46,'"729"','"Ruby"',184,178,362
'"309847"','"tripleplay"','"16"',57,0,57,'"993"','"Java"',997,7,1004
'"310505"','"collective.nitf"','"256"',3,2,5,'"960"','"Python"',745,36,781
'"313109"','"sisu-goodies"','"28"',18,2,20,'"855"','"Java"',309,21,330
'"313546"','"logstash-metlog"','"11"',0,0,0,'"707"','"Ruby"',188,9,197
'"314730"','"pd-cap-recipes"','"13"',0,0,0,'"759"','"Ruby"',64,12,76
'"314739"','"titanium_studio_sdk"','"81"',0,1,1,'"713"','"Java"',50,1,51
'"315291"','"personas"','"12"',0,0,0,'"702"','"Ruby"',37,0,37
'"316261"','"PRQA"','"12"',0,0,0,'"721"','"Java"',114,0,114
'"317545"','"cloudkick"','"26"',0,0,0,'"722"','"Ruby"',37,4,41
'"317593"','"com.idega.content"','"11"',8,0,8,'"1712"','"Java"',367,0,367
'"317981"','"collective.ptg.contentleadimage"','"256"',0,0,0,'"569"','"Python"',2,0,2
'"318132"','"memo-app-services"','"10"',0,0,0,'"659"','"Java"',25,0,25
'"318190"','"synergy"','"21"',0,0,0,'"1059"','"Java"',103,0,103
'"318279"','"ki_middleman"','"23"',0,0,0,'"570"','"Ruby"',50,1,51
'"318322"','"flooding"','"15"',8,0,8,'"633"','"Python"',431,0,431
'"318654"','"lizard-maptree"','"13"',0,0,0,'"659"','"Python"',74,1,75
'"321791"','"crazy_harry"','"22"',0,0,0,'"629"','"Ruby"',77,1,78
'"322194"','"tictactoe"','"14"',0,0,0,'"1108"','"Java"',31,0,31
'"322279"','"ro-manager"','"22"',3,0,3,'"926"','"Python"',515,16,531
'"322340"','"deadline_camp"','"19"',0,0,0,'"650"','"Ruby"',303,0,303
'"322390"','"plone.app.workflow"','"149"',6,1,7,'"893"','"Python"',128,3,131
'"322494"','"PRQA-api"','"12"',0,0,0,'"721"','"Java"',185,0,185
'"322949"','"firewall"','"26"',10,6,16,'"722"','"Ruby"',44,19,63
'"322975"','"cirb.novac"','"10"',0,0,0,'"877"','"Python"',118,0,118
'"323197"','"is.idega.idegaweb.egov.bpm"','"10"',43,0,43,'"1687"','"Java"',524,0,524
'"323800"','"glow"','"16"',0,0,0,'"920"','"Ruby"',86,4,90
'"324846"','"Rmodules"','"11"',23,2,25,'"681"','"Java"',94,6,100
'"326632"','"robottelo"','"12"',195,124,319,'"693"','"Python"',579,263,842
'"326815"','"repoman"','"12"',0,0,0,'"1254"','"Python"',254,0,254
'"326995"','"cids-maven-plugin"','"10"',0,0,0,'"574"','"Java"',130,0,130
'"328149"','"true_queue"','"10"',0,0,0,'"741"','"Ruby"',51,1,52
'"328167"','"ftw.geo"','"14"',1,0,1,'"569"','"Python"',80,10,90
'"328979"','"PrismPay-Gateway"','"10"',0,0,0,'"738"','"Ruby"',113,0,113
'"329151"','"ticketevolution-ruby"','"10"',6,1,7,'"813"','"Ruby"',380,6,386
'"331002"','"FHNW-Informatik-Zusammenfassungen"','"14"',24,1,25,'"717"','"Java"',288,24,312
'"332674"','"nuxeo-cmf"','"22"',4,0,4,'"812"','"Java"',395,2,397
'"333080"','"RZAndroidBaseUtils"','"17"',4,0,4,'"664"','"Java"',80,5,85
'"333321"','"FCAQCustomZK"','"10"',8,0,8,'"636"','"Java"',164,0,164
'"333382"','"RZAndroidWebServiceManager"','"17"',4,0,4,'"575"','"Java"',104,3,107
'"333400"','"jclouds-examples"','"19"',8,3,11,'"1121"','"Java"',165,34,199
'"333732"','"cargo-mule-container"','"74"',0,0,0,'"1052"','"Java"',92,0,92
'"333984"','"gds-sso"','"55"',36,8,44,'"974"','"Ruby"',306,37,343
'"335607"','"TestFiles"','"49"',1,0,1,'"826"','"Python"',108,0,108
'"335654"','"zencoder-rb"','"11"',0,0,0,'"1441"','"Ruby"',47,6,53
'"337260"','"Products.ImageEditor"','"257"',0,0,0,'"797"','"Python"',117,0,117
'"339028"','"collective.portlet.contentleadimage"','"257"',0,0,0,'"569"','"Python"',26,0,26
'"339639"','"ella-tagging"','"11"',0,0,0,'"764"','"Python"',6,1,7
'"339786"','"HA-Monitor"','"50"',0,0,0,'"569"','"Java"',40,0,40
'"339890"','"commons-data-model"','"179"',0,0,0,'"674"','"Java"',35,2,37
'"340304"','"appengine-mapreduce"','"10"',5,0,5,'"569"','"Python"',131,0,131
'"341640"','"commons-data-dao"','"148"',0,0,0,'"674"','"Java"',33,2,35
'"342319"','"commons-data-mongodao"','"148"',0,0,0,'"626"','"Java"',29,0,29
'"342521"','"compliance-orb"','"19"',0,0,0,'"621"','"Java"',11,0,11
'"343288"','"puppet-module-tool"','"83"',0,0,0,'"1388"','"Ruby"',148,17,165
'"343835"','"gricli"','"11"',0,0,0,'"1135"','"Java"',563,12,575
'"343960"','"Project-Voodo"','"12"',0,0,0,'"704"','"Python"',10,1,11
'"344679"','"Products.ATContentTypes"','"149"',9,1,10,'"838"','"Python"',213,5,218
'"344763"','"Products.CMFDynamicViewFTI"','"149"',0,0,0,'"838"','"Python"',48,0,48
'"344790"','"Products.CMFPlacefulWorkflow"','"149"',0,0,0,'"838"','"Python"',80,4,84
'"344864"','"Products.PasswordResetTool"','"149"',9,0,9,'"897"','"Python"',120,3,123
'"344927"','"plone.rfc822"','"149"',0,0,0,'"898"','"Python"',47,0,47
'"344945"','"plone.behavior"','"149"',0,0,0,'"898"','"Python"',45,0,45
'"344973"','"plone.app.z3cform"','"149"',14,1,15,'"898"','"Python"',187,14,201
'"345020"','"plone.app.textfield"','"149"',0,0,0,'"898"','"Python"',85,4,89
'"345216"','"plone.app.kss"','"149"',0,0,0,'"893"','"Python"',101,0,101
'"345244"','"plone.app.imaging"','"149"',3,0,3,'"897"','"Python"',141,4,145
'"345300"','"Products.PlonePAS"','"149"',7,0,7,'"897"','"Python"',141,1,142
'"346896"','"bart"','"19"',6,0,6,'"2093"','"Ruby"',251,0,251
'"347227"','"swp-uebersetzerbau-ss12"','"26"',0,0,0,'"693"','"Java"',193,2,195
'"347655"','"liquid"','"11"',32,18,50,'"819"','"Python"',431,117,548
'"348414"','"findbugs-plugin"','"301"',7,0,7,'"1178"','"Java"',317,4,321
'"348515"','"rhoconnect-adapters"','"13"',0,0,0,'"993"','"Ruby"',42,1,43
'"348533"','"libxpublisher"','"295"',0,0,0,'"678"','"Java"',11,0,11
'"348540"','"rhohub-api"','"14"',0,0,0,'"730"','"Ruby"',26,0,26
'"348549"','"buildcontext-capture-plugin"','"295"',0,0,0,'"904"','"Java"',29,0,29
'"349004"','"django-htmlmin"','"21"',3,2,5,'"1029"','"Python"',194,23,217
'"349149"','"list_master"','"38"',0,0,0,'"727"','"Ruby"',85,4,89
'"349467"','"nuxeo-platform-rendition"','"22"',13,0,13,'"812"','"Java"',122,0,122
'"349948"','"PBS.bundle"','"15"',0,0,0,'"1316"','"Python"',56,14,70
'"350169"','"digipost-api-client-java"','"11"',48,0,48,'"883"','"Java"',230,0,230
'"351460"','"openquake-packages"','"13"',0,0,0,'"1129"','"Java"',282,46,328
'"352091"','"graphite"','"26"',0,0,0,'"568"','"Python"',59,7,66
'"352480"','"heroku-deploy"','"13"',0,0,0,'"722"','"Ruby"',41,2,43
'"352633"','"metasploit_data_models"','"32"',36,5,41,'"797"','"Ruby"',511,55,566
'"352799"','"calendars"','"90"',13,6,19,'"849"','"Ruby"',501,54,555
'"352931"','"application_config"','"31"',0,0,0,'"1779"','"Ruby"',3,2,5
'"353004"','"PharoByExample-spanish"','"15"',0,0,0,'"1244"','"Ruby"',109,0,109
'"353083"','"fenix-framework"','"13"',0,0,0,'"710"','"Java"',703,71,774
'"353085"','"Camfed"','"11"',0,0,0,'"1127"','"Ruby"',216,24,240
'"353500"','"collective.jsonify"','"257"',4,0,4,'"1101"','"Python"',87,4,91
'"354154"','"EatItTimeForce"','"14"',0,0,0,'"856"','"Ruby"',5,0,5
'"355077"','"com.idega.block.process"','"10"',2,0,2,'"1709"','"Java"',154,0,154
'"355109"','"com.idega.bpm"','"10"',6,0,6,'"1688"','"Java"',197,0,197
'"355197"','"org.jboss.jbpm"','"10"',12,0,12,'"1688"','"Java"',480,0,480
'"355271"','"limelight_docs"','"38"',0,0,0,'"1667"','"Ruby"',181,1,182
'"356033"','"Telephony-Dev-Box"','"11"',10,0,10,'"909"','"Ruby"',223,12,235
'"357021"','"teefaa"','"12"',3,0,3,'"651"','"Python"',423,0,423
'"357450"','"ceph-qa-chef"','"28"',7,0,7,'"911"','"Ruby"',253,2,255
'"358571"','"sitenow_articles"','"11"',0,0,0,'"636"','"Ruby"',107,0,107
'"358638"','"sitenow_events"','"11"',0,0,0,'"636"','"Ruby"',98,0,98
'"358696"','"sitenow_featured_slider"','"11"',0,0,0,'"636"','"Ruby"',82,0,82
'"359432"','"coverage-model"','"20"',24,12,36,'"603"','"Python"',470,148,618
'"359515"','"discovery"','"23"',0,0,0,'"1060"','"Java"',39,0,39
'"360057"','"e2openplugin-SetPicon"','"22"',0,0,0,'"613"','"Python"',40,1,41
'"360521"','"dd-agent-deps"','"12"',0,0,0,'"872"','"Python"',21,0,21
'"360982"','"server-aitc"','"11"',0,0,0,'"723"','"Python"',110,1,111
'"361214"','"on_ruby"','"10"',37,3,40,'"1179"','"Ruby"',863,44,907
'"361288"','"mimesis-mediagal"','"11"',0,0,0,'"828"','"Python"',97,0,97
'"364110"','"fluxtream-cli"','"10"',0,0,0,'"758"','"Java"',31,1,32
'"365466"','"irccat-commands"','"11"',0,0,0,'"1393"','"Python"',123,3,126
'"366311"','"multilane"','"13"',0,0,0,'"646"','"Java"',60,0,60
'"366532"','"green-eggs"','"17"',0,0,0,'"946"','"Ruby"',155,1,156
'"367400"','"adapter_generator"','"28"',0,0,0,'"884"','"Ruby"',25,0,25
'"367621"','"mangrove"','"32"',52,0,52,'"812"','"Python"',572,0,572
'"369238"','"datawinners-smartphone"','"32"',0,0,0,'"647"','"Python"',3,0,3
'"369246"','"Products.PloneGazette"','"257"',6,1,7,'"639"','"Python"',71,1,72
'"369711"','"omniauth-mindvalley"','"11"',1,0,1,'"855"','"Ruby"',11,0,11
'"370660"','"ALP"','"10"',0,0,0,'"913"','"Java"',33,0,33
'"370918"','"favorite-plugin"','"301"',0,0,0,'"1179"','"Java"',58,2,60
'"371533"','"WHAT"','"11"',1,0,1,'"718"','"Python"',89,1,90
'"372745"','"ki_format"','"23"',0,0,0,'"567"','"Ruby"',21,0,21
'"373241"','"fh-android-sdk"','"22"',0,0,0,'"618"','"Java"',80,7,87
'"373488"','"heroku-deploy"','"18"',0,0,0,'"577"','"Ruby"',13,0,13
'"373783"','"templer.core"','"257"',0,0,0,'"710"','"Python"',105,4,109
'"374122"','"org.ops4j.pax.wicket"','"60"',2,1,3,'"1154"','"Java"',273,16,289
'"374831"','"nested-view-plugin"','"295"',0,0,0,'"1179"','"Java"',72,17,89
'"375331"','"tabnav"','"33"',0,0,0,'"1336"','"Ruby"',97,1,98
'"375574"','"openengsb-root"','"15"',0,0,0,'"1171"','"Python"',187,13,200
'"375633"','"nexus-p2-bridge-plugin"','"28"',0,0,0,'"1007"','"Java"',53,5,58
'"375649"','"ki_trello"','"23"',0,0,0,'"567"','"Ruby"',30,0,30
'"375974"','"ftw.dashboard.portlets.recentlymodified"','"14"',0,0,0,'"825"','"Python"',131,3,134
'"376633"','"sonatype-ci-for-jenkins"','"29"',0,0,0,'"567"','"Java"',29,0,29
'"377320"','"ruminate"','"15"',0,0,0,'"797"','"Ruby"',14,0,14
'"377647"','"noexcuses"','"23"',0,0,0,'"568"','"Java"',66,0,66
'"378842"','"api_resource"','"16"',12,0,12,'"906"','"Ruby"',264,0,264
'"379254"','"doc"','"12"',0,0,0,'"776"','"Python"',45,0,45
'"379536"','"iw.rejectanonymous"','"257"',0,0,0,'"679"','"Python"',31,0,31
'"379983"','"image5d"','"14"',5,0,5,'"567"','"Java"',50,0,50
'"380655"','"mateme"','"14"',0,0,0,'"2092"','"Ruby"',413,0,413
'"380886"','"dropbox-connector"','"74"',11,0,11,'"882"','"Java"',53,2,55
'"381252"','"Ming"','"23"',0,0,0,'"563"','"Python"',81,0,81
'"381881"','"vraptor-returnparams"','"10"',0,0,0,'"567"','"Java"',3,0,3
'"382332"','"CouchbaseMock"','"50"',7,0,7,'"974"','"Java"',107,2,109
'"382553"','"vtv.web.locales"','"18"',0,0,0,'"567"','"Python"',6,0,6
'"382689"','"i2b2_1.6_Postgres"','"11"',0,0,0,'"681"','"Java"',21,1,22
'"383141"','"jenkow-plugin"','"302"',0,0,0,'"654"','"Java"',105,2,107
'"383936"','"sample-xlink-java-client"','"16"',0,0,0,'"622"','"Java"',16,2,18
'"383985"','"plone.app.intid"','"230"',2,0,2,'"898"','"Python"',15,2,17
'"384173"','"collective.pfg.starrating"','"257"',0,0,0,'"574"','"Python"',10,0,10
'"384343"','"crawler4j"','"13"',0,0,0,'"658"','"Java"',71,0,71
'"384805"','"workflow"','"14"',6,0,6,'"601"','"Java"',63,0,63
'"385667"','"jive-connector"','"83"',0,0,0,'"952"','"Java"',115,0,115
'"386840"','"engineyard-serverside-adapter"','"11"',0,0,0,'"1269"','"Ruby"',152,8,160
'"387161"','"collective.newsflash"','"257"',0,0,0,'"835"','"Python"',132,1,133
'"387947"','"plone.app.referenceablebehavior"','"149"',0,0,0,'"898"','"Python"',46,1,47
'"389363"','"anznn"','"26"',13,0,13,'"787"','"Ruby"',358,0,358
'"390550"','"QTIMigrationTool"','"12"',0,0,0,'"1120"','"Python"',79,0,79
'"391856"','"omniauth-att"','"70"',0,0,0,'"820"','"Ruby"',81,5,86
'"393202"','"qdo"','"11"',0,0,0,'"777"','"Python"',432,0,432
'"394429"','"cloudfactory_ruby"','"40"',0,0,0,'"1039"','"Ruby"',337,1,338
'"394661"','"apitester"','"32"',27,1,28,'"609"','"Java"',125,4,129
'"395882"','"almodovar"','"16"',8,2,10,'"1428"','"Ruby"',133,7,140
'"396065"','"workshop-amazon-beanstalk-cocktail"','"34"',0,0,0,'"566"','"Java"',2,0,2
'"396248"','"call_roulette"','"76"',0,0,0,'"897"','"Ruby"',18,0,18
'"396751"','"Diaketas-Manage"','"11"',0,0,0,'"665"','"Java"',29,3,32
'"398258"','"nuxeo-platform-forms-layout-demo"','"22"',12,0,12,'"812"','"Java"',243,0,243
'"399405"','"github_hook_handler"','"13"',0,0,0,'"752"','"Ruby"',16,2,18
'"399532"','"archetypes.multilingual"','"149"',1,0,1,'"975"','"Python"',51,6,57
'"399631"','"config-rotator-plugin"','"12"',1,0,1,'"729"','"Java"',296,3,299
'"400044"','"freeseer-docs"','"16"',35,3,38,'"714"','"Python"',266,33,299
'"400585"','"xebia-cloudcomputing-extras"','"43"',0,0,0,'"666"','"Java"',277,1,278
'"400833"','"collective.loremipsum"','"257"',0,0,0,'"819"','"Python"',86,3,89
'"401284"','"theyworkforyou"','"20"',440,14,454,'"1492"','"Python"',1265,49,1314
'"401437"','"toolbox"','"23"',0,0,0,'"871"','"Ruby"',32,0,32
'"401667"','"intellij-samples"','"13"',0,0,0,'"701"','"Java"',11,0,11
'"402176"','"pathfinder_distributor"','"10"',2,0,2,'"763"','"Ruby"',86,0,86
'"402696"','"vtv.web.contenttypes"','"20"',0,0,0,'"594"','"Python"',13,0,13
'"402728"','"active_record_host_pool"','"85"',2,1,3,'"1065"','"Ruby"',86,3,89
'"403256"','"openmultimedia.contenttypes"','"17"',0,0,0,'"597"','"Python"',41,0,41
'"403957"','"redu-wall-cli"','"15"',0,0,0,'"574"','"Python"',3,0,3
'"404399"','"octarine"','"36"',0,0,0,'"860"','"Ruby"',35,2,37
'"407060"','"wicked"','"149"',0,0,0,'"838"','"Python"',63,0,63
'"407223"','"out-of-box-setup"','"95"',0,0,0,'"1045"','"Ruby"',119,0,119
'"407274"','"catkin"','"13"',85,17,102,'"850"','"Python"',1750,225,1975
'"408009"','"exercise-screens"','"29"',0,0,0,'"569"','"Python"',38,0,38
'"408138"','"abanalyzer"','"74"',0,0,0,'"1176"','"Ruby"',10,0,10
'"408579"','"Superbus"','"13"',1,0,1,'"697"','"Java"',49,0,49
'"409579"','"sass.ruble"','"15"',0,0,0,'"1506"','"Ruby"',53,1,54
'"410169"','"HUeducation"','"12"',0,0,0,'"1007"','"Java"',95,0,95
'"410372"','"ruby_flipper"','"24"',0,0,0,'"1182"','"Ruby"',37,2,39
'"412916"','"holoserve"','"22"',0,0,0,'"819"','"Ruby"',143,4,147
'"412967"','"kafkaesque"','"98"',0,0,0,'"821"','"Ruby"',22,4,26
'"414409"','"client"','"12"',72,2,74,'"683"','"Python"',615,2,617
'"414516"','"bristleback"','"10"',1,0,1,'"610"','"Java"',367,5,372
'"417726"','"easybuild.experimental"','"22"',2,0,2,'"565"','"Python"',127,2,129
'"417964"','"station-software"','"12"',1,2,3,'"736"','"Python"',82,2,84
'"418207"','"dashboard-view-plugin"','"298"',2,1,3,'"1179"','"Java"',81,23,104
'"418572"','"cloudsync"','"15"',0,0,0,'"666"','"Java"',13,0,13
'"419150"','"LockDown"','"15"',0,0,0,'"565"','"Java"',15,0,15
'"419303"','"pegadi"','"10"',0,0,0,'"926"','"Java"',153,0,153
'"421417"','"CSIRL"','"10"',30,0,30,'"820"','"Python"',163,3,166
'"422082"','"emma-plugin"','"300"',0,0,0,'"1179"','"Java"',299,4,303
'"425809"','"wsgi-helloworld"','"15"',0,0,0,'"689"','"Python"',6,1,7
'"426176"','"buildout.bootstrap"','"257"',0,0,0,'"939"','"Python"',84,3,87
'"426605"','"metlog-raven"','"11"',0,0,0,'"622"','"Python"',47,4,51
'"426988"','"ArcBees-Infrastructure"','"16"',0,0,0,'"824"','"Java"',34,6,40
'"427919"','"Mesa-Robotics-Organization"','"14"',0,0,0,'"869"','"Java"',98,1,99
'"429684"','"openmultimedia.api"','"17"',0,0,0,'"639"','"Python"',59,3,62
'"430764"','"MCSquared"','"15"',0,0,0,'"565"','"Java"',45,8,53
'"431671"','"nsi-minlog"','"15"',0,0,0,'"629"','"Java"',148,2,150
'"432888"','"djenesis"','"14"',0,0,0,'"910"','"Python"',62,4,66
'"437697"','"toybox-webapp"','"77"',0,0,0,'"566"','"Ruby"',14,0,14
'"439402"','"JamomaRuby"','"13"',4,0,4,'"1274"','"Ruby"',93,0,93
'"439676"','"org.ops4j.pax.jdbc"','"60"',0,0,0,'"630"','"Java"',40,1,41
'"443327"','"monitoring-plugin"','"310"',14,1,15,'"1179"','"Java"',240,2,242
'"445346"','"components-ness-jdbi"','"15"',0,0,0,'"666"','"Java"',31,11,42
'"445979"','"OpenConextApps-Canvas-lms"','"14"',0,0,0,'"610"','"Ruby"',50,0,50
'"448414"','"pyramid_tm"','"14"',0,1,1,'"1109"','"Python"',64,6,70
'"454271"','"ui-test"','"30"',211,0,211,'"570"','"Java"',1613,0,1613
'"456655"','"security"','"23"',2,18,20,'"1836"','"Java"',153,59,212
'"457546"','"com.idega.slide"','"10"',0,0,0,'"1712"','"Java"',102,0,102
'"457681"','"collective.tinymceportlets"','"259"',0,0,0,'"884"','"Python"',22,0,22
'"457846"','"com.idega.block.category"','"10"',0,0,0,'"1688"','"Java"',96,0,96
'"458061"','"lizard-progress"','"15"',48,3,51,'"762"','"Python"',491,14,505
'"458206"','"teamcity-rest-api-extension"','"18"',0,0,0,'"743"','"Java"',21,0,21
'"458317"','"dc12c"','"27"',0,0,0,'"731"','"Ruby"',326,0,326
'"458700"','"borg.localrole"','"151"',2,0,2,'"897"','"Python"',77,0,77
'"459255"','"android-oauth-app"','"14"',0,0,0,'"570"','"Java"',13,1,14
'"460036"','"plone.resource"','"235"',0,0,0,'"899"','"Python"',76,4,80
'"460133"','"nuxeo-diff"','"22"',8,0,8,'"763"','"Java"',305,0,305
'"460403"','"pmd-plugin"','"309"',6,0,6,'"1178"','"Java"',331,1,332
'"461228"','"wps-helicopter-reachability"','"12"',0,0,0,'"604"','"Java"',8,3,11
'"461748"','"Products.ATReferenceBrowserWidget"','"151"',0,0,0,'"889"','"Python"',75,0,75
'"462898"','"nuxeo-platform-classification"','"22"',9,0,9,'"812"','"Java"',117,0,117
'"462900"','"nuxeo-http-client"','"22"',7,0,7,'"812"','"Java"',90,0,90
'"462902"','"nuxeo-platform-importer"','"22"',9,1,10,'"812"','"Java"',220,4,224
'"462912"','"nuxeo-platform-error-web"','"22"',15,0,15,'"812"','"Java"',155,0,155
'"462915"','"nuxeo-platform-smart-search"','"22"',7,0,7,'"812"','"Java"',133,0,133
'"462919"','"nuxeo-shell"','"22"',10,0,10,'"812"','"Java"',113,0,113
'"462923"','"nuxeo-platform-users-management-compat"','"22"',2,0,2,'"812"','"Java"',60,0,60
'"462927"','"nuxeo-platform-audio"','"22"',8,0,8,'"812"','"Java"',131,0,131
'"462928"','"nuxeo-platform-sync"','"22"',3,0,3,'"812"','"Java"',155,0,155
'"462931"','"nuxeo-apidoc-server"','"22"',7,0,7,'"812"','"Java"',223,0,223
'"462934"','"nuxeo-poll"','"22"',10,0,10,'"974"','"Java"',128,0,128
'"462940"','"nuxeo-signature"','"22"',8,0,8,'"745"','"Java"',162,0,162
'"462956"','"nuxeo-exalead-connector"','"22"',7,0,7,'"770"','"Java"',82,0,82
'"463560"','"jslint-source-ruby"','"25"',0,1,1,'"773"','"Ruby"',4,1,5
'"463640"','"fmk-schemas"','"23"',21,0,21,'"708"','"Java"',391,0,391
'"464016"','"infinispan-archetypes"','"23"',0,0,0,'"1185"','"Java"',52,1,53
'"464556"','"safe_redirection"','"10"',0,0,0,'"602"','"Ruby"',7,4,11
'"466298"','"collective.portlet.contentsearch"','"259"',0,0,0,'"576"','"Python"',4,0,4
'"466871"','"gocardless-java"','"13"',0,1,1,'"605"','"Java"',74,14,88
'"467731"','"Tested.bundle"','"15"',0,0,0,'"848"','"Python"',9,1,10
'"468578"','"components-ness-jdbc"','"16"',0,0,0,'"752"','"Java"',47,7,54
'"468752"','"components-ness-jmx4log"','"16"',0,0,0,'"776"','"Java"',15,2,17
'"468951"','"components-ness-scopes"','"16"',0,0,0,'"760"','"Java"',21,3,24
'"469788"','"rspec-example_steps"','"43"',0,0,0,'"799"','"Ruby"',13,6,19
'"469934"','"passwdstack"','"12"',0,0,0,'"567"','"Python"',25,0,25
'"470111"','"plone.folder"','"151"',0,0,0,'"898"','"Python"',102,1,103
'"470539"','"service-solo"','"16"',0,0,0,'"574"','"Java"',6,0,6
'"470612"','"testing-findbugs-annotations"','"16"',0,0,0,'"751"','"Java"',4,0,4
'"470629"','"android-timer"','"53"',0,0,0,'"652"','"Java"',76,0,76
'"470824"','"logdweb"','"12"',1,0,1,'"973"','"Python"',80,0,80
'"470829"','"KSE"','"14"',0,0,0,'"657"','"Java"',16,0,16
'"471859"','"mygengo-ruby"','"10"',0,0,0,'"1000"','"Ruby"',54,13,67
'"472169"','"components-ness-metrics"','"16"',0,0,0,'"743"','"Java"',10,1,11
'"473851"','"basespace-java-sdk"','"25"',1,0,1,'"686"','"Java"',28,2,30
'"474572"','"mince_model"','"31"',0,0,0,'"563"','"Ruby"',5,1,6
'"474742"','"mule-module-datapack"','"76"',0,0,0,'"1025"','"Java"',54,0,54
'"475102"','"gem_publisher"','"53"',3,1,4,'"665"','"Ruby"',45,5,50
'"475330"','"ubuntu-packaging-floodlight"','"34"',0,0,0,'"654"','"Java"',66,1,67
'"476208"','"knife-rackspace-load-balancer"','"22"',0,1,1,'"695"','"Ruby"',20,2,22
'"476305"','"linkscape-gem"','"58"',0,0,0,'"1401"','"Ruby"',114,3,117
'"476371"','"scrivener"','"116"',0,0,0,'"576"','"Python"',29,2,31
'"476636"','"twss"','"10"',0,0,0,'"650"','"Python"',44,0,44
'"476798"','"idea-stapler-plugin"','"10"',0,0,0,'"1072"','"Java"',107,1,108
'"477312"','"transmogrify.joomla2nitf"','"18"',0,0,0,'"565"','"Python"',2,0,2
'"477331"','"ckanext-datahub"','"13"',11,1,12,'"685"','"Python"',113,7,120
'"477510"','"xapian_db"','"12"',0,0,0,'"1186"','"Ruby"',276,14,290
'"477526"','"lognit-cli"','"11"',0,0,0,'"786"','"Java"',354,1,355
'"479556"','"grails-plugin"','"301"',0,0,0,'"1179"','"Java"',204,9,213
'"480009"','"cmd_states"','"10"',4,0,4,'"881"','"Python"',128,7,135
'"481246"','"cookbooks"','"13"',0,0,0,'"1296"','"Ruby"',113,5,118
'"482001"','"docsplit-server"','"13"',0,0,0,'"1014"','"Ruby"',59,2,61
'"482012"','"web_tsunami"','"13"',0,0,0,'"643"','"Ruby"',5,0,5
'"482255"','"whensday"','"14"',0,0,0,'"562"','"Ruby"',10,0,10
'"483343"','"govuk_content_api"','"100"',92,25,117,'"633"','"Ruby"',864,167,1031
'"483378"','"officialfm-v2-ruby"','"12"',0,0,0,'"608"','"Ruby"',23,0,23
'"483666"','"wf-ro"','"25"',0,0,0,'"660"','"Java"',130,0,130
'"484845"','"analysis-test-plugin"','"309"',4,0,4,'"1179"','"Java"',171,0,171
'"485905"','"ananya-reference-data"','"49"',17,0,17,'"652"','"Java"',243,0,243
'"486404"','"file-list-maven-plugin"','"41"',0,0,0,'"987"','"Java"',15,1,16
'"487124"','"redu-wall-web"','"15"',0,0,0,'"570"','"Python"',3,0,3
'"487343"','"corr"','"11"',2,0,2,'"827"','"Python"',180,2,182
'"487390"','"plone.app.event-ploneintegration"','"258"',0,0,0,'"734"','"Python"',8,0,8
'"487494"','"zojax.members"','"15"',1,0,1,'"970"','"Python"',31,0,31
'"487599"','"dropwizard-spring"','"12"',3,1,4,'"612"','"Java"',22,8,30
'"488606"','"django-soil"','"12"',4,2,6,'"930"','"Python"',70,12,82
'"489159"','"synapsePythonClient"','"30"',3,4,7,'"562"','"Python"',206,132,338
'"489826"','"pagoda-cli"','"11"',0,0,0,'"1228"','"Ruby"',122,0,122
'"489923"','"cpi-event-connector"','"21"',0,0,0,'"682"','"Ruby"',83,0,83
'"490586"','"SwaggerToMarkdown"','"24"',0,0,0,'"562"','"Ruby"',5,0,5
'"490761"','"deferred_job"','"13"',0,0,0,'"590"','"Ruby"',17,0,17
'"490868"','"preproduction"','"11"',0,0,0,'"1120"','"Python"',48,0,48
'"491810"','"platform-api-rb"','"16"',0,0,0,'"986"','"Ruby"',75,0,75
'"493013"','"wix"','"25"',0,0,0,'"722"','"Ruby"',12,1,13
'"495935"','"Projeto-Coruja"','"14"',0,0,0,'"612"','"Java"',429,0,429
'"496425"','"right_scraper"','"77"',1,0,1,'"1503"','"Ruby"',289,31,320
'"497205"','"nengo"','"25"',107,18,125,'"868"','"Python"',1737,140,1877
'"499863"','"zsh"','"25"',0,0,0,'"722"','"Ruby"',34,1,35
'"500908"','"openmrs-module-jsslab"','"21"',0,0,0,'"562"','"Java"',103,0,103
'"502334"','"dm-restful-adapter"','"18"',0,0,0,'"699"','"Ruby"',28,0,28
'"502834"','"sms_mta"','"49"',0,0,0,'"747"','"Python"',24,0,24
'"503811"','"DrupalUpdater"','"17"',0,0,0,'"561"','"Python"',4,0,4
'"503922"','"com.idega.block.text"','"10"',0,0,0,'"1688"','"Java"',103,0,103
'"504488"','"dry-plugin"','"308"',10,0,10,'"1178"','"Java"',150,2,152
'"504501"','"tasks-plugin"','"308"',6,0,6,'"1178"','"Java"',326,0,326
'"504512"','"nuxeo-web-embedded"','"20"',1,0,1,'"812"','"Java"',45,0,45
'"504522"','"analysis-collector-plugin"','"308"',5,0,5,'"1179"','"Java"',325,1,326
'"505022"','"Products.OpenXml"','"258"',0,0,0,'"651"','"Python"',43,0,43
'"506029"','"JahiApp-Newsletter"','"23"',3,0,3,'"1053"','"Java"',125,0,125
'"506872"','"zojax.content.hooks"','"15"',1,0,1,'"561"','"Python"',9,0,9
'"507295"','"bpms-common"','"23"',0,0,0,'"583"','"Java"',29,10,39
'"507547"','"openmrs-module-hr"','"21"',0,0,0,'"561"','"Java"',111,0,111
'"508238"','"msautotest"','"15"',14,0,14,'"702"','"Python"',364,25,389
'"508398"','"Products.Carousel"','"258"',4,0,4,'"561"','"Python"',123,7,130
'"508499"','"hello-java-mysql"','"15"',0,0,0,'"688"','"Java"',16,0,16
'"508746"','"Django-Boilerplate"','"19"',0,0,0,'"696"','"Python"',17,0,17
'"511078"','"mokoid"','"23"',0,0,0,'"839"','"Java"',14,2,16
'"511754"','"authem"','"10"',25,1,26,'"841"','"Ruby"',136,15,151
'"512123"','"Products.PloneOntology"','"259"',0,0,0,'"563"','"Python"',9,0,9
'"513279"','"MMUnB"','"12"',5,4,9,'"559"','"Java"',39,9,48
'"516670"','"weather-rooster"','"15"',0,0,0,'"561"','"Ruby"',227,0,227
'"517631"','"packaging"','"171"',36,28,64,'"587"','"Ruby"',331,273,604
'"518088"','"uptospeed"','"13"',0,0,0,'"894"','"Ruby"',135,0,135
'"519084"','"rspec-dns"','"18"',4,3,7,'"561"','"Ruby"',13,5,18
'"519893"','"nuxeo-platform-suggestbox"','"22"',10,0,10,'"863"','"Java"',168,1,169
'"521831"','"skynet"','"18"',0,0,0,'"946"','"Ruby"',24,0,24
'"522041"','"jangaroo-tools"','"56"',12,0,12,'"1262"','"Java"',339,0,339
'"522727"','"JasigWidgetPortlets"','"16"',3,0,3,'"722"','"Java"',112,7,119
'"523087"','"StackMob_Android"','"20"',0,0,0,'"876"','"Java"',92,2,94
'"523118"','"python-twisted-keystone-agent"','"113"',0,0,0,'"563"','"Python"',70,0,70
'"523746"','"object-graph-mapper"','"10"',0,0,0,'"748"','"Java"',66,0,66
'"526190"','"com.idega.builder"','"11"',6,0,6,'"1712"','"Java"',345,0,345
'"526220"','"com.idega.faces"','"11"',3,0,3,'"1712"','"Java"',108,0,108
'"526766"','"VagrantDeductor"','"37"',0,0,0,'"560"','"Java"',2,0,2
'"526810"','"GHANA-TELCO"','"56"',0,0,0,'"895"','"Java"',116,0,116
'"527152"','"collective.flowplayer"','"259"',4,0,4,'"561"','"Python"',112,3,115
'"527910"','"pusher-test"','"10"',3,0,3,'"993"','"Ruby"',105,1,106
'"528265"','"sdm4-core"','"10"',0,0,0,'"560"','"Java"',118,0,118
'"528389"','"capture"','"16"',0,0,0,'"828"','"Python"',162,2,164
'"529450"','"oerpub.rhaptoslabs.latex2cnxml"','"15"',0,0,0,'"792"','"Python"',17,0,17
'"529986"','"countdown.o.o"','"15"',0,0,0,'"888"','"Python"',41,3,44
'"530170"','"hotels_pro"','"12"',0,0,0,'"569"','"Ruby"',76,0,76
'"530450"','"gevent-thrift"','"10"',3,2,5,'"688"','"Python"',6,2,8
'"530772"','"rapidsms-smsforms"','"11"',0,0,0,'"717"','"Python"',52,3,55
'"530921"','"jpylyzer"','"37"',49,0,49,'"764"','"Python"',216,3,219
'"531080"','"re-education"','"15"',0,0,0,'"559"','"Ruby"',262,50,312
'"532336"','"moveit-play"','"10"',0,0,0,'"560"','"Java"',9,0,9
'"533074"','"basex-examples"','"12"',0,0,0,'"1113"','"Java"',297,1,298
'"533138"','"xwiki-platform-component-wiki"','"17"',0,0,0,'"989"','"Java"',15,0,15
'"534217"','"form-builder-ng"','"36"',0,0,0,'"560"','"Java"',45,3,48
'"534678"','"foreman-export-god"','"12"',0,0,0,'"763"','"Ruby"',12,0,12
'"535338"','"com.idega.block.importer"','"10"',0,0,0,'"1688"','"Java"',99,0,99
'"535397"','"com.idega.block.rss"','"10"',0,0,0,'"1712"','"Java"',174,0,174
'"536179"','"telemetry-toolbox"','"17"',1,1,2,'"854"','"Java"',74,10,84
'"536244"','"hlsclient"','"15"',0,0,0,'"678"','"Python"',228,1,229
'"536596"','"deploytool"','"10"',1,0,1,'"835"','"Python"',168,7,175
'"536978"','"gandalf"','"11"',0,0,0,'"567"','"Ruby"',17,6,23
'"539222"','"release-testing"','"49"',0,0,0,'"559"','"Java"',29,0,29
'"540308"','"spring-reference"','"13"',0,0,0,'"815"','"Java"',177,0,177
'"542126"','"fabix"','"14"',0,0,0,'"611"','"Python"',45,1,46
'"542335"','"doms-exports-mcm"','"10"',0,0,0,'"559"','"Java"',2,0,2
'"542474"','"swprobe"','"23"',0,0,0,'"744"','"Python"',27,0,27
'"542603"','"doms-bitstorage"','"10"',0,0,0,'"560"','"Java"',93,0,93
'"542619"','"doms-auth-checker"','"10"',0,0,0,'"560"','"Java"',107,0,107
'"542646"','"doms-gui"','"10"',0,0,0,'"560"','"Java"',154,0,154
'"542663"','"doms-client"','"10"',0,0,0,'"560"','"Java"',141,0,141
'"542677"','"doms-ecm"','"10"',0,0,0,'"560"','"Java"',102,0,102
'"542684"','"doms-pid-generator"','"10"',0,0,0,'"560"','"Java"',72,0,72
'"542713"','"doms-update-tracker"','"10"',0,0,0,'"560"','"Java"',134,0,134
'"542978"','"db_structure_ext"','"24"',0,0,0,'"876"','"Ruby"',8,0,8
'"543189"','"doms-extractors"','"10"',0,0,0,'"560"','"Java"',94,0,94
'"543217"','"doms-surveillance"','"10"',0,0,0,'"560"','"Java"',97,0,97
'"543240"','"doms-util"','"10"',0,0,0,'"560"','"Java"',101,0,101
'"543384"','"google-auth-bridge"','"26"',0,0,0,'"577"','"Ruby"',29,0,29
'"543927"','"fileserver"','"58"',0,0,0,'"785"','"Java"',12,1,13
'"545221"','"collective.cart.shopping"','"322"',5,0,5,'"609"','"Python"',202,0,202
'"545680"','"standup"','"23"',0,0,0,'"1172"','"Ruby"',125,0,125
'"546037"','"android"','"42"',335,39,374,'"558"','"Java"',1238,137,1375
'"548967"','"fin-eng"','"13"',0,0,0,'"605"','"Python"',13,0,13
'"550360"','"vagrant_bootstrap"','"11"',0,0,0,'"605"','"Ruby"',62,1,63
'"551733"','"eradio-playlist-generator"','"18"',0,0,0,'"975"','"Python"',46,1,47
'"555034"','"XMTV-Import"','"15"',1,0,1,'"612"','"Python"',71,0,71
'"555334"','"doms-ingesters"','"10"',0,0,0,'"560"','"Java"',133,0,133
'"555434"','"doms-integrations"','"10"',0,0,0,'"560"','"Java"',165,0,165
'"555694"','"doms-tools"','"10"',0,0,0,'"560"','"Java"',36,0,36
'"558322"','"django-quickbooks"','"12"',1,0,1,'"623"','"Python"',15,0,15
'"558493"','"modello"','"31"',1,1,2,'"1219"','"Java"',110,8,118
'"559394"','"compress"','"16"',4,0,4,'"1333"','"Java"',190,7,197
'"560221"','"nexus-bundle-maker-plugin"','"28"',0,0,0,'"1017"','"Java"',50,0,50
'"561722"','"viki-gem"','"29"',0,0,0,'"631"','"Ruby"',74,1,75
'"565425"','"recommended-links"','"58"',2,1,3,'"812"','"Ruby"',116,18,134
'"566684"','"shared-objects-plugin"','"305"',0,0,0,'"773"','"Java"',150,1,151
'"569250"','"mab"','"12"',0,0,0,'"782"','"Ruby"',39,0,39
'"573742"','"omg_pull_request"','"23"',0,0,0,'"556"','"Ruby"',87,9,96
'"573907"','"ananya-batch"','"49"',0,0,0,'"717"','"Java"',16,0,16
'"574818"','"bes-media-file-status-log"','"10"',0,0,0,'"559"','"Java"',12,0,12
'"575133"','"thot"','"44"',0,0,0,'"602"','"Java"',266,0,266
'"577032"','"pg_client"','"16"',0,0,0,'"555"','"Java"',310,0,310
'"578744"','"pubsub-bootstrap-service"','"10"',0,0,0,'"652"','"Java"',35,0,35
'"579782"','"mule-packaging-tasks"','"75"',0,0,0,'"1063"','"Java"',9,0,9
'"579827"','"jasy-compat"','"10"',0,0,0,'"721"','"Python"',37,0,37
'"580112"','"loot"','"10"',0,0,0,'"705"','"Ruby"',40,0,40
'"580674"','"rengen"','"17"',0,0,0,'"790"','"Python"',74,0,74
'"582636"','"crowdblog"','"49"',0,0,0,'"745"','"Ruby"',266,6,272
'"583582"','"com.idega.springframework"','"11"',0,0,0,'"1712"','"Java"',86,0,86
'"584244"','"chute-ruby"','"15"',0,0,0,'"896"','"Ruby"',78,0,78
'"585569"','"collective.behavior.vat"','"260"',0,0,0,'"620"','"Python"',24,0,24
'"586970"','"pathfinder-reports"','"12"',0,0,0,'"1080"','"Python"',57,6,63
'"587397"','"vertex-connector"','"98"',0,0,0,'"724"','"Java"',68,0,68
'"587529"','"trippi"','"14"',0,0,0,'"1180"','"Java"',118,1,119
'"588049"','"babelsubs"','"12"',3,2,5,'"556"','"Python"',199,10,209
'"588451"','"mule-module-objectstore"','"75"',0,0,0,'"826"','"Java"',71,0,71
'"588537"','"elastictastic"','"11"',0,0,0,'"950"','"Ruby"',65,7,72
'"589153"','"Products.CalendarX"','"260"',0,0,0,'"556"','"Python"',45,0,45
'"592261"','"collective.ptg.sheetgallery"','"260"',0,0,0,'"561"','"Python"',17,0,17
'"592337"','"doms-transformers"','"10"',0,0,0,'"560"','"Java"',193,0,193
'"593524"','"com.idega.block.cal"','"10"',0,0,0,'"1688"','"Java"',309,0,309
'"594262"','"ella-polls"','"11"',0,0,0,'"765"','"Python"',3,0,3
'"594418"','"sonar-scm-activity"','"27"',5,4,9,'"792"','"Java"',101,6,107
'"594752"','"collective.behavior.price"','"260"',0,0,0,'"620"','"Python"',28,0,28
'"594792"','"Python-Huddle-Api-Example"','"15"',0,0,0,'"555"','"Python"',2,0,2
'"594915"','"collective.behavior.discount"','"260"',0,0,0,'"616"','"Python"',24,0,24
'"597726"','"is.idega.block.family"','"10"',4,0,4,'"1688"','"Java"',110,0,110
'"598926"','"fmk-dosis-til-tekst"','"22"',18,0,18,'"617"','"Java"',116,0,116
'"599019"','"es_dump_restore"','"21"',0,0,0,'"559"','"Ruby"',11,4,15
'"599522"','"ZenPacks.zenoss.OpenStack"','"22"',17,1,18,'"1016"','"Python"',89,2,91
'"600192"','"play-governance"','"10"',0,0,0,'"594"','"Java"',126,0,126
'"600259"','"collective.cmcicpaiement"','"260"',0,0,0,'"582"','"Python"',19,0,19
'"600344"','"collective.portlet.nivoslider"','"260"',0,0,0,'"561"','"Python"',3,0,3
'"601023"','"java-util"','"14"',7,0,7,'"867"','"Java"',274,7,281
'"601301"','"java-to-as3"','"20"',0,0,0,'"727"','"Java"',20,1,21
'"601951"','"debug-bar"','"24"',0,0,0,'"555"','"Ruby"',45,2,47
'"602154"','"e2openplugin-SimpleUmount"','"18"',0,0,0,'"798"','"Python"',15,1,16
'"602465"','"sampledoc"','"15"',0,0,0,'"1111"','"Python"',17,1,18
'"603289"','"collective.behavior.salable"','"260"',0,0,0,'"618"','"Python"',21,0,21
'"603404"','"asis"','"51"',0,0,0,'"555"','"Python"',5,0,5
'"603513"','"cmis-connector"','"98"',5,0,5,'"1112"','"Java"',242,3,245
'"604608"','"maven-hudson-dev-plugin"','"293"',0,0,0,'"1492"','"Java"',38,0,38
'"604791"','"dargparse"','"11"',0,0,0,'"718"','"Python"',33,2,35
'"605769"','"twilio-connector"','"75"',0,0,0,'"983"','"Java"',77,0,77
'"606887"','"paypal-connector"','"99"',0,0,0,'"1052"','"Java"',142,0,142
'"607054"','"smilodon"','"18"',0,0,0,'"1029"','"Ruby"',96,0,96
'"608656"','"ektorp-lucene-spike"','"49"',0,0,0,'"554"','"Java"',11,0,11
'"608779"','"buffered_logger_extension"','"10"',0,0,0,'"855"','"Ruby"',7,0,7
'"609042"','"collective.behavior.size"','"260"',0,0,0,'"595"','"Python"',23,0,23
'"612974"','"github-connector"','"97"',5,1,6,'"777"','"Java"',104,6,110
'"613416"','"lizard-task"','"13"',0,0,0,'"736"','"Python"',93,1,94
'"613554"','"templer.plone"','"260"',0,0,0,'"710"','"Python"',97,2,99
'"614053"','"alaveteli"','"31"',161,15,176,'"1192"','"Ruby"',5553,300,5853
'"616539"','"plone.app.ldap"','"234"',0,0,0,'"838"','"Python"',59,4,63
'"616575"','"magic-config-service"','"12"',0,0,0,'"734"','"Java"',106,0,106
'"618725"','"plone.app.jqueryui"','"168"',0,0,0,'"624"','"Python"',7,0,7
'"619217"','"collective.cropimage"','"261"',0,0,0,'"700"','"Python"',25,0,25
'"619778"','"schema-to-pojo"','"13"',5,5,10,'"661"','"Java"',91,7,98
'"620212"','"collective.behavior.stock"','"261"',0,0,0,'"620"','"Python"',28,0,28
'"620230"','"incogito"','"10"',0,0,0,'"1719"','"Java"',95,0,95
'"621174"','"css605_2012"','"14"',0,0,0,'"554"','"Python"',120,1,121
'"621232"','"OpenComm-Group"','"15"',0,0,0,'"896"','"Java"',580,0,580
'"621685"','"PortfolioKanban"','"11"',0,0,0,'"661"','"Ruby"',8,1,9
'"622343"','"plone.namedfile"','"234"',25,1,26,'"898"','"Python"',142,8,150
'"623322"','"eclipse-update-site-plugin"','"293"',0,0,0,'"553"','"Java"',10,0,10
'"624647"','"QAT"','"12"',1,0,1,'"871"','"Python"',31,0,31
'"625799"','"collective.collection.yearview"','"261"',0,0,0,'"553"','"Python"',11,0,11
'"627269"','"common"','"16"',0,0,0,'"1162"','"Python"',15,0,15
'"627375"','"koji-setup"','"16"',0,0,0,'"1159"','"Python"',15,0,15
'"627520"','"re-revisor-configs"','"16"',0,0,0,'"858"','"Python"',21,0,21
'"628032"','"shoulda-context"','"68"',13,1,14,'"1177"','"Ruby"',61,21,82
'"628128"','"apis"','"24"',0,0,0,'"632"','"Python"',35,0,35
'"628206"','"cap_gun"','"34"',0,0,0,'"2162"','"Ruby"',0,2,2
'"628558"','"jangaroo-idea"','"13"',37,0,37,'"926"','"Java"',176,0,176
'"629389"','"nuxeo-connect"','"22"',13,0,13,'"650"','"Java"',225,0,225
'"631739"','"capistrano-ext-projectdx"','"10"',0,0,0,'"1359"','"Ruby"',75,2,77
'"631974"','"isfotobuk"','"14"',0,0,0,'"553"','"Java"',103,0,103
'"632411"','"api-v2-android-client"','"15"',0,0,0,'"567"','"Java"',11,0,11
'"634864"','"rcov"','"36"',0,0,0,'"1763"','"Ruby"',203,9,212
'"635556"','"slim-plugin"','"11"',12,0,12,'"637"','"Java"',118,0,118
'"635692"','"server-full2"','"11"',1,0,1,'"626"','"Python"',20,1,21
'"636085"','"scli"','"27"',0,0,0,'"609"','"Ruby"',22,0,22
'"640869"','"plugins"','"12"',0,0,0,'"818"','"Java"',96,0,96
'"641217"','"chiru-extras"','"19"',0,0,0,'"828"','"Python"',19,0,19
'"641383"','"django-project-template"','"16"',0,0,0,'"696"','"Python"',30,0,30
'"641394"','"collective.linguafaq"','"261"',0,0,0,'"552"','"Python"',65,0,65
'"641837"','"collective.referencedatagridfield"','"261"',3,0,3,'"843"','"Python"',32,1,33
'"642071"','"collective.panels"','"261"',0,0,0,'"707"','"Python"',135,6,141
'"643400"','"jcr-benchmark"','"13"',6,0,6,'"701"','"Java"',296,0,296
'"643589"','"yandex_direct_api"','"25"',0,0,0,'"552"','"Ruby"',3,0,3
'"643805"','"feedback"','"66"',79,19,98,'"553"','"Ruby"',575,117,692
'"644208"','"bamboo.scaffold"','"19"',0,0,0,'"553"','"Python"',107,6,113
'"644582"','"openmonitor-android-agent"','"10"',0,0,0,'"558"','"Java"',192,0,192
'"646167"','"inventory"','"13"',0,0,0,'"552"','"Python"',95,0,95
'"646241"','"capistrano-hivequeen"','"22"',1,1,2,'"885"','"Ruby"',121,3,124
'"646578"','"owb"','"10"',0,0,0,'"552"','"Java"',85,0,85
'"647105"','"bearapps-license-server"','"11"',0,0,0,'"552"','"Python"',10,0,10
'"647696"','"awesomebits"','"24"',7,0,7,'"772"','"Ruby"',361,38,399
'"649612"','"collective.cart.stock"','"261"',0,0,0,'"599"','"Python"',24,0,24
'"649904"','"e2openplugin-AutoShutDown"','"18"',0,0,0,'"886"','"Python"',13,2,15
'"651433"','"Products.DateRangeInRangeIndex"','"261"',4,0,4,'"1094"','"Python"',10,0,10
'"651465"','"imageproc_py"','"17"',0,0,0,'"637"','"Python"',1,0,1
'"653683"','"repozitory"','"15"',0,0,0,'"960"','"Python"',43,0,43
'"660846"','"org.ops4j.base"','"60"',0,0,0,'"1095"','"Java"',104,0,104
'"666158"','"fishtank"','"19"',0,0,0,'"550"','"Java"',40,0,40
'"671232"','"db-migration-cmdline"','"26"',0,0,0,'"549"','"Java"',3,0,3
'"671344"','"bemyndigelsesregister"','"22"',0,0,0,'"729"','"Java"',70,0,70
'"671561"','"zojax.widget.checkbox"','"15"',1,0,1,'"972"','"Python"',8,0,8
'"671878"','"aim-client-java"','"21"',5,3,8,'"679"','"Java"',63,10,73
'"673093"','"AVForums.bundle"','"15"',0,0,0,'"1316"','"Python"',20,0,20
'"673199"','"decision-tree"','"52"',0,0,0,'"1064"','"Ruby"',26,0,26
'"673410"','"eea.uberlisting"','"12"',7,0,7,'"549"','"Python"',55,1,56
'"674069"','"plone.app.locales"','"261"',11,1,12,'"551"','"Python"',313,29,342
'"674311"','"sdm4-vitaminimporter"','"18"',0,0,0,'"549"','"Java"',83,0,83
'"674609"','"clamav-plugin"','"293"',0,0,0,'"985"','"Java"',43,0,43
'"674797"','"log_colorizer"','"13"',0,0,0,'"923"','"Python"',11,0,11
'"676511"','"redux-client-ruby"','"20"',2,0,2,'"876"','"Ruby"',74,0,74
'"680394"','"two_tents"','"14"',3,0,3,'"1692"','"Ruby"',348,0,348
'"680667"','"telesur.theme"','"16"',32,0,32,'"924"','"Python"',473,0,473
'"681729"','"cppcheck-plugin"','"301"',0,1,1,'"1179"','"Java"',128,3,131
'"682241"','"hbcitsports"','"22"',0,0,0,'"643"','"Java"',157,0,157
'"682349"','"piece_pipe"','"12"',0,0,0,'"645"','"Ruby"',16,0,16
'"683443"','"vraptor-flex"','"18"',0,0,0,'"622"','"Java"',15,0,15
'"683714"','"collective.listingviews"','"261"',0,0,0,'"553"','"Python"',144,4,148
'"684696"','"sdm4-maven-plugin"','"18"',0,0,0,'"552"','"Java"',2,0,2
'"685218"','"Products.PloneSoftwareCenter"','"261"',0,0,0,'"961"','"Python"',140,5,145
'"685693"','"podio_rails_sample"','"10"',0,0,0,'"784"','"Ruby"',8,1,9
'"685753"','"sdm4-autorisationimporter"','"18"',0,0,0,'"549"','"Java"',29,0,29
'"685826"','"notify_custom_users"','"29"',0,0,0,'"548"','"Ruby"',9,0,9
'"686558"','"collective.ptg.uigallery"','"261"',0,0,0,'"549"','"Python"',12,0,12
'"689415"','"sdm4-cprimporter"','"18"',0,0,0,'"549"','"Java"',23,0,23
'"689419"','"sdm4-bemyndigelseimporter"','"18"',0,0,0,'"549"','"Java"',38,0,38
'"689439"','"sdm4-sikredeimporter"','"18"',0,0,0,'"549"','"Java"',34,0,34
'"689449"','"sdm4-sksimporter"','"18"',0,0,0,'"549"','"Java"',24,0,24
'"689453"','"sdm4-sorimporter"','"18"',0,0,0,'"549"','"Java"',22,0,22
'"689456"','"sdm4-sorrelationimporter"','"18"',0,0,0,'"549"','"Java"',18,0,18
'"689458"','"sdm4-takstimporter"','"18"',0,0,0,'"549"','"Java"',24,0,24
'"689534"','"sdm4-yderimporter"','"18"',0,0,0,'"549"','"Java"',28,0,28
'"689549"','"Concurrency-Course"','"19"',0,0,0,'"706"','"Java"',22,0,22
'"689576"','"the-lambda-experiment"','"18"',0,0,0,'"882"','"Java"',29,0,29
'"691254"','"collective.twitter.tweet"','"261"',0,0,0,'"548"','"Python"',7,0,7
'"691816"','"wildcard.lockdown"','"261"',0,0,0,'"730"','"Python"',10,0,10
'"692351"','"Products.csvreplicata"','"261"',0,0,0,'"678"','"Python"',112,2,114
'"692767"','"pathological"','"22"',0,0,0,'"909"','"Ruby"',65,3,68
'"692866"','"GWTP"','"21"',109,21,130,'"548"','"Java"',1481,217,1698
'"694047"','"collective.portlets.lineage"','"261"',0,0,0,'"756"','"Python"',33,0,33
'"694333"','"nolan-django-tutorial"','"16"',0,0,0,'"548"','"Python"',2,0,2
'"694335"','"OpenConext-test"','"12"',0,0,0,'"716"','"Java"',102,0,102
'"694379"','"nsi.metadataextractor"','"18"',0,0,0,'"582"','"Python"',29,0,29
'"695474"','"front_end_excercise"','"30"',0,0,0,'"548"','"Ruby"',15,0,15
'"696001"','"openplans-vote-counter"','"18"',0,0,0,'"555"','"Java"',6,0,6
'"696239"','"getbarkeep.org"','"21"',0,0,0,'"767"','"Ruby"',5,0,5
'"696346"','"plone.subrequest"','"168"',2,0,2,'"899"','"Python"',56,1,57
'"696536"','"seqware"','"15"',60,8,68,'"664"','"Java"',2356,172,2528
'"697249"','"jcu.common"','"11"',0,0,0,'"547"','"Python"',27,0,27
'"697829"','"nephology"','"13"',0,0,0,'"742"','"Ruby"',7,0,7
'"699315"','"channel-directory"','"16"',11,0,11,'"1044"','"Java"',77,1,78
'"699924"','"openoffice-wrapper"','"15"',0,0,0,'"547"','"Python"',7,0,7
'"700803"','"dawn-fable"','"12"',5,0,5,'"779"','"Java"',87,3,90
'"700952"','"desi"','"21"',17,2,19,'"547"','"Ruby"',103,2,105
'"701145"','"brap"','"19"',0,0,0,'"647"','"Java"',94,0,94
'"701654"','"robot-viewer"','"19"',0,0,0,'"1240"','"Python"',302,0,302
'"702733"','"green-hakai"','"14"',0,0,0,'"693"','"Python"',47,8,55
'"704132"','"collective.lineage"','"320"',0,0,0,'"771"','"Python"',128,3,131
'"704568"','"betterplace-theme"','"16"',0,0,0,'"547"','"Ruby"',3,0,3
'"704698"','"bamboo.recipies"','"19"',0,0,0,'"553"','"Python"',5,0,5
'"705134"','"backlog-plugin"','"292"',0,0,0,'"1179"','"Java"',95,1,96
'"705688"','"OpenConext-selfservice"','"13"',3,0,3,'"661"','"Java"',475,0,475
'"706405"','"iron_worker_rails_example"','"14"',0,0,0,'"1038"','"Ruby"',57,0,57
'"706524"','"pg_power"','"14"',33,6,39,'"786"','"Ruby"',159,36,195
'"707491"','"park"','"30"',0,0,0,'"548"','"Python"',22,2,24
'"707937"','"elasticsearch-zookeeper"','"30"',0,1,1,'"895"','"Java"',67,15,82
'"710282"','"protected_attributes"','"24"',0,0,0,'"548"','"Ruby"',41,14,55
'"710911"','"paperclip_demo"','"35"',2,2,4,'"581"','"Ruby"',34,6,40
'"711256"','"hiccupy"','"21"',0,0,0,'"603"','"Java"',4,0,4
'"711302"','"jcu.words"','"12"',0,0,0,'"560"','"Python"',19,0,19
'"711505"','"pyramid-default"','"15"',0,0,0,'"689"','"Python"',2,0,2
'"712822"','"seismic"','"11"',0,0,0,'"546"','"Java"',9,1,10
'"712930"','"crowdin-maven-plugin"','"17"',6,0,6,'"632"','"Java"',240,1,241
'"714623"','"sdm4-doseringimporter"','"18"',0,0,0,'"549"','"Java"',17,0,17
'"715293"','"doms-server"','"10"',15,0,15,'"560"','"Java"',219,0,219
'"716257"','"nuxeo-platform-audit-web-access"','"21"',1,0,1,'"812"','"Java"',44,0,44
'"717539"','"leiningen-plugin"','"23"',0,0,0,'"594"','"Java"',30,1,31
'"717689"','"sdm4-testutils"','"18"',0,0,0,'"549"','"Java"',15,0,15
'"718075"','"tempo-processes"','"23"',1,7,8,'"1819"','"Java"',69,11,80
'"718518"','"zojax.content.browser"','"15"',1,0,1,'"968"','"Python"',41,0,41
'"718568"','"zojax.content.type"','"15"',0,0,0,'"968"','"Python"',32,0,32
'"718602"','"zojax.permissionsmap"','"15"',0,0,0,'"970"','"Python"',8,0,8
'"718734"','"openedge"','"57"',0,0,0,'"833"','"Java"',95,0,95
'"719116"','"nexus-archetype-common"','"28"',0,0,0,'"1060"','"Java"',20,0,20
'"719963"','"telesur.forums"','"16"',0,0,0,'"696"','"Python"',47,0,47
'"720140"','"lizard-waterbalance"','"13"',0,0,0,'"876"','"Python"',147,0,147
'"720401"','"maven-mirah-plugin"','"13"',0,0,0,'"1079"','"Java"',21,4,25
'"721702"','"pyramid-virginia"','"15"',0,0,0,'"689"','"Python"',3,0,3
'"721821"','"sisu"','"29"',8,0,8,'"1282"','"Java"',436,5,441
'"722087"','"stars-causes"','"28"',1,0,1,'"622"','"Ruby"',194,3,197
'"723460"','"telesur.contenttypes"','"16"',0,0,0,'"803"','"Python"',44,0,44
'"724199"','"play-hello"','"15"',0,0,0,'"688"','"Java"',5,0,5
'"724822"','"cryo"','"59"',0,0,0,'"546"','"Ruby"',82,8,90
'"724922"','"nuxeo-platform-semantic-entities"','"22"',3,0,3,'"812"','"Java"',389,0,389
'"724980"','"sc.contentrules.groupbydate"','"264"',9,0,9,'"827"','"Python"',129,2,131
'"725052"','"rumble-cookbooks"','"12"',0,0,0,'"728"','"Ruby"',25,0,25
'"725182"','"transmogrify.siteanalyser"','"264"',0,0,0,'"1441"','"Python"',116,1,117
'"725214"','"transmogrify.webcrawler"','"264"',5,0,5,'"1445"','"Python"',83,0,83
'"726997"','"vhm"','"21"',0,0,0,'"545"','"Java"',393,1,394
'"728589"','"sonar-scm-stats"','"17"',0,0,0,'"545"','"Java"',61,3,64
'"730573"','"plone.multilingual"','"170"',0,0,0,'"975"','"Python"',68,8,76
'"730648"','"collective.behavior.localregistry"','"264"',0,0,0,'"545"','"Python"',13,0,13
'"731317"','"nuxeo-platform-categorization"','"22"',7,0,7,'"812"','"Java"',90,0,90
'"731324"','"nuxeo-platform-user-dashboard-compat"','"22"',2,0,2,'"812"','"Java"',72,0,72
'"731328"','"nuxeo-platform-shibboleth-groups-web"','"22"',9,0,9,'"812"','"Java"',99,1,100
'"731329"','"nuxeo-dam"','"22"',20,0,20,'"827"','"Java"',567,2,569
'"732911"','"marketplace-platform-explorer"','"21"',2,0,2,'"547"','"Java"',18,0,18
'"734055"','"support"','"21"',2,0,2,'"546"','"Java"',107,1,108
'"734211"','"ss2json"','"17"',0,0,0,'"659"','"Ruby"',45,1,46
'"735153"','"openmrs-module-patientregistration"','"10"',1,0,1,'"548"','"Java"',174,0,174
'"735311"','"sensei-rb"','"30"',0,0,0,'"675"','"Ruby"',77,5,82
'"735322"','"cloudbees-plugin-gateway"','"300"',3,0,3,'"689"','"Java"',51,1,52
'"735461"','"jirafe-ruby-client"','"19"',0,0,0,'"591"','"Ruby"',48,0,48
'"735585"','"sonar-ldap"','"17"',2,0,2,'"629"','"Java"',96,2,98
'"735621"','"cap-swallow"','"22"',0,0,0,'"975"','"Ruby"',39,9,48
'"736923"','"pet-catalog"','"15"',0,0,0,'"618"','"Java"',16,0,16
'"737679"','"RTL-XL.bundle"','"15"',1,0,1,'"1316"','"Python"',37,0,37
'"738073"','"npm-maven-plugin"','"79"',0,0,0,'"554"','"Java"',11,1,12
'"738329"','"Products.ATSuccessStory"','"264"',0,0,0,'"563"','"Python"',21,0,21
'"739598"','"view-job-filters-plugin"','"292"',0,0,0,'"1179"','"Java"',98,3,101
'"743269"','"Products.ifQuotes"','"264"',0,0,0,'"544"','"Python"',4,0,4
'"748210"','"liferayImageSlider"','"15"',0,0,0,'"714"','"Java"',40,0,40
'"749170"','"nuxeo-multi-tenant"','"22"',10,0,10,'"876"','"Java"',122,0,122
'"749842"','"jenkins.plone.org"','"171"',41,0,41,'"846"','"Python"',132,2,134
'"750958"','"global3"','"10"',0,0,0,'"1226"','"Ruby"',94,0,94
'"752396"','"p4a.ploneevent"','"264"',0,0,0,'"563"','"Python"',58,0,58
'"754226"','"configus"','"18"',3,1,4,'"852"','"Ruby"',36,6,42
'"754806"','"openmrs-module-uiframework-patientsummary-support"','"11"',0,0,0,'"543"','"Java"',3,0,3
'"756108"','"tymore"','"16"',0,0,0,'"586"','"Java"',64,0,64
'"757150"','"omg-ci"','"22"',0,0,0,'"543"','"Ruby"',42,0,42
'"758823"','"dynamodb-hackday"','"37"',0,0,0,'"542"','"Ruby"',3,0,3
'"759011"','"ftw.billboard"','"14"',0,0,0,'"829"','"Python"',139,5,144
'"759820"','"ms_rakefile_source"','"46"',0,0,0,'"542"','"Ruby"',21,0,21
'"760127"','"sonar-settings"','"10"',1,0,1,'"785"','"Java"',24,0,24
'"760129"','"collective.generic.webbuilder"','"264"',6,0,6,'"1156"','"Python"',156,1,157
'"761471"','"ix-search-terms-dashlet"','"20"',0,0,0,'"545"','"Java"',7,0,7
'"761993"','"SEP12"','"11"',0,0,0,'"542"','"Java"',1390,0,1390
'"762466"','"collective.configviews"','"264"',0,0,0,'"1002"','"Python"',70,0,70
'"762595"','"telesur.locales"','"16"',0,0,0,'"798"','"Python"',15,0,15
'"763551"','"FWTPodspecs"','"10"',15,0,15,'"563"','"Ruby"',95,0,95
'"765540"','"g5_page_view"','"29"',0,0,0,'"1162"','"Ruby"',58,0,58
'"766375"','"nuxeo-sample-project"','"22"',1,0,1,'"812"','"Java"',48,0,48
'"766993"','"recess-maven-plugin"','"79"',0,0,0,'"549"','"Java"',11,0,11
'"768902"','"scidea-schools"','"12"',0,0,0,'"780"','"Ruby"',70,0,70
'"768967"','"collective.recipe.rsync"','"264"',27,0,27,'"877"','"Python"',104,4,108
'"769427"','"g5stars"','"29"',7,1,8,'"671"','"Ruby"',36,2,38
'"771217"','"test-amo-validator"','"19"',0,0,0,'"1095"','"Python"',60,0,60
'"772239"','"repoze.who.plugins.browserid"','"11"',0,0,0,'"869"','"Python"',31,1,32
'"772631"','"translate_interface"','"18"',0,0,0,'"545"','"Ruby"',60,0,60
'"774540"','"collective.pfgpreview"','"264"',0,0,0,'"686"','"Python"',22,0,22
'"774772"','"eventstore"','"15"',1,0,1,'"896"','"Java"',30,0,30
'"776217"','"sdm4-vaccinationimporter"','"18"',0,0,0,'"541"','"Java"',30,0,30
'"776763"','"drmemory-api"','"12"',0,0,0,'"751"','"Java"',37,2,39
'"777221"','"support"','"105"',76,23,99,'"541"','"Ruby"',1011,141,1152
'"777370"','"url-pinger"','"37"',0,0,0,'"589"','"Python"',7,1,8
'"778167"','"asset-bank-rest-api-reprs"','"14"',0,0,0,'"745"','"Java"',43,0,43
'"778322"','"asset-bank-rest-api-client-utils"','"14"',0,0,0,'"745"','"Java"',28,0,28
'"779959"','"archivator"','"17"',16,0,16,'"540"','"Java"',282,0,282
'"781798"','"quick_client"','"28"',2,0,2,'"937"','"Ruby"',44,0,44
'"787470"','"nova-gerrit-monitor"','"17"',0,0,0,'"758"','"Ruby"',19,0,19
'"788836"','"e2openplugin-RemoteChannelStreamConverter"','"19"',0,0,0,'"704"','"Python"',12,2,14
'"789540"','"gridtk"','"12"',10,0,10,'"740"','"Python"',138,0,138
'"792243"','"activeasync"','"15"',0,0,0,'"769"','"Ruby"',39,3,42
'"794786"','"escidoc-oaiprovider"','"12"',0,0,0,'"553"','"Java"',5,0,5
'"794931"','"collective.cart.core"','"265"',0,0,0,'"618"','"Python"',172,0,172
'"795615"','"coding-dojo"','"12"',0,0,0,'"924"','"Ruby"',126,0,126
'"795994"','"mashdotfiles"','"22"',0,0,0,'"1099"','"Python"',36,0,36
'"796148"','"rubyftw.org"','"17"',0,0,0,'"1085"','"Ruby"',124,4,128
'"796279"','"puavo-ca"','"10"',0,0,0,'"1352"','"Ruby"',56,0,56
'"796702"','"bobmaker"','"13"',0,0,0,'"746"','"Python"',14,0,14
'"796708"','"mg42"','"16"',0,0,0,'"540"','"Java"',27,0,27
'"796767"','"fmaven"','"16"',0,0,0,'"540"','"Java"',8,0,8
'"796806"','"store_spree"','"13"',0,0,0,'"587"','"Ruby"',18,0,18
'"797790"','"collective.topictree"','"265"',0,0,0,'"641"','"Python"',45,0,45
'"798033"','"wix-maven-teamcity7-plugin"','"18"',0,0,0,'"613"','"Java"',18,0,18
'"799532"','"Planet-Nuxeo"','"22"',0,0,0,'"1023"','"Python"',18,0,18
'"799899"','"examples"','"10"',0,0,0,'"710"','"Java"',48,3,51
'"800100"','"zax"','"10"',129,0,129,'"633"','"Java"',351,0,351
'"800431"','"auslfe.formonline.pfgadapter"','"12"',0,0,0,'"602"','"Python"',90,0,90
'"800586"','"web-debug-tag"','"18"',0,0,0,'"598"','"Java"',138,0,138
'"801225"','"collective.externalimageeditor"','"265"',0,0,0,'"770"','"Python"',49,0,49
'"801441"','"Activiti"','"19"',128,32,160,'"539"','"Java"',3339,192,3531
'"801536"','"Meetings"','"13"',0,0,0,'"1021"','"Ruby"',32,1,33
'"801950"','"virtual-cluster"','"13"',0,0,0,'"745"','"Python"',160,0,160
'"802559"','"WebproxyPortlet"','"16"',0,0,0,'"722"','"Java"',138,8,146
'"803060"','"scout-plugins"','"24"',0,0,0,'"1106"','"Ruby"',14,0,14
'"803650"','"bugzilla_etl"','"17"',2,0,2,'"1102"','"Java"',162,0,162
'"804289"','"liferay-service-mock-generator"','"10"',0,0,0,'"540"','"Java"',9,0,9
'"804523"','"dexterity.membrane"','"265"',1,0,1,'"540"','"Python"',114,3,117
'"804680"','"rightsmetadata-policyfinder"','"16"',0,0,0,'"540"','"Java"',7,0,7
'"805210"','"collective.recipe.i18noverrides"','"265"',0,0,0,'"540"','"Python"',45,0,45
'"805231"','"collective.depositbox"','"265"',0,0,0,'"540"','"Python"',39,0,39
'"805251"','"collective.editskinswitcher"','"265"',0,0,0,'"540"','"Python"',112,0,112
'"805267"','"collective.emaillogin"','"265"',0,0,0,'"540"','"Python"',104,0,104
'"805275"','"collective.noindexing"','"265"',0,0,0,'"540"','"Python"',41,1,42
'"805280"','"collective.portlet.relateditems"','"265"',0,0,0,'"540"','"Python"',47,0,47
'"805299"','"collective.realestatebroker"','"265"',0,0,0,'"540"','"Python"',96,0,96
'"805309"','"sphinx-demo"','"15"',0,0,0,'"688"','"Python"',4,0,4
'"805316"','"collective.sortmyfolder"','"265"',0,0,0,'"540"','"Python"',62,0,62
'"805325"','"permit"','"15"',0,0,0,'"560"','"Ruby"',34,1,35
'"805326"','"poi.receivemail"','"265"',0,0,0,'"540"','"Python"',53,0,53
'"805333"','"smtp2zope"','"265"',0,0,0,'"540"','"Python"',21,0,21
'"805374"','"ThinkBigAnalytics-Pig-Extension"','"20"',0,0,0,'"1035"','"Java"',10,0,10
'"805394"','"Products.feedfeeder"','"265"',10,0,10,'"540"','"Python"',123,3,126
'"805498"','"ceph-deploy"','"37"',18,17,35,'"540"','"Python"',434,164,598
'"805765"','"bundle-dev.ruble"','"15"',0,0,0,'"1500"','"Ruby"',93,0,93
'"807659"','"railscamps.com"','"15"',2,0,2,'"1664"','"Ruby"',28,5,33
'"809672"','"fedora-genericsearch-2.2"','"12"',0,0,0,'"553"','"Java"',134,0,134
'"809721"','"fgs-lucene-2.2"','"12"',0,0,0,'"555"','"Java"',72,0,72
'"809757"','"fgs-solr-22.2"','"12"',0,0,0,'"555"','"Java"',32,0,32
'"810646"','"xforms-manager"','"24"',0,0,0,'"1836"','"Java"',70,4,74
'"811856"','"balrog"','"11"',5,0,5,'"875"','"Python"',45,15,60
'"812246"','"byte-cloudwatch"','"11"',0,0,0,'"546"','"Python"',29,0,29
'"812820"','"wc.pageturner"','"320"',0,0,0,'"583"','"Python"',15,2,17
'"813048"','"modernizr-examtime"','"11"',0,0,0,'"777"','"Ruby"',12,0,12
'"814423"','"CONNECT-AdapterCommonDataLayer"','"20"',0,0,0,'"541"','"Java"',4,0,4
'"815254"','"plugin-solr"','"24"',0,0,0,'"539"','"Java"',10,0,10
'"815806"','"CONNECT-AdapterMpi"','"20"',0,0,0,'"541"','"Java"',31,0,31
'"815981"','"cloudkey-java"','"24"',0,0,0,'"1018"','"Java"',35,1,36
'"816098"','"cloud-metrics"','"13"',1,0,1,'"776"','"Python"',357,0,357
'"816122"','"CONNECT-DocumentManager"','"20"',0,0,0,'"541"','"Java"',42,0,42
'"816562"','"CONNECT-NHINAdapterService"','"20"',0,0,0,'"541"','"Java"',48,0,48
'"816585"','"reevoomark-java-api"','"12"',2,0,2,'"1581"','"Java"',33,3,36
'"817920"','"rap-maven-examples"','"18"',0,0,0,'"601"','"Java"',3,0,3
'"817963"','"passifier"','"45"',0,0,0,'"540"','"Ruby"',87,3,90
'"820103"','"rails3-application-templates"','"22"',0,0,0,'"698"','"Ruby"',35,1,36
'"821079"','"gevent-app"','"10"',1,1,2,'"689"','"Python"',22,8,30
'"821309"','"reportek-converters"','"12"',1,0,1,'"540"','"Python"',56,0,56
'"821552"','"spiraleye_openerp_addons_6.1"','"11"',0,0,0,'"538"','"Python"',3,0,3
'"821610"','"kitchen"','"22"',0,0,0,'"707"','"Ruby"',37,7,44
'"821660"','"emf.compare.acceptance.tests"','"10"',0,0,0,'"538"','"Java"',69,0,69
'"823324"','"zauber-openfutbol"','"10"',0,0,0,'"538"','"Ruby"',20,0,20
'"823342"','"pg_application_name"','"27"',0,0,0,'"538"','"Ruby"',15,2,17
'"823636"','"nuxeo-csv"','"22"',10,0,10,'"538"','"Java"',49,0,49
'"823656"','"plugin-XMLSiteMap"','"24"',4,2,6,'"538"','"Java"',10,2,12
'"823713"','"har-viewer"','"45"',0,1,1,'"538"','"Ruby"',4,1,5
'"824151"','"metacoruja-spring"','"13"',0,0,0,'"539"','"Java"',44,0,44
'"824435"','"supernanny"','"34"',0,0,0,'"538"','"Java"',14,2,16
'"824649"','"pg_advisory_locker"','"27"',0,0,0,'"538"','"Ruby"',13,3,16
'"824682"','"CONNECT-AdapterDocumentRepository"','"20"',0,0,0,'"541"','"Java"',5,0,5
'"824970"','"msmbuilder"','"17"',152,46,198,'"553"','"Python"',1051,133,1184
'"825095"','"CONNECT-AdapterDocumentAssemblyProxy"','"20"',0,0,0,'"541"','"Java"',100,0,100
'"825924"','"unknown-horizons"','"35"',96,11,107,'"1291"','"Python"',8490,244,8734
'"827302"','"kidsrubyinstaller-debian"','"23"',2,0,2,'"538"','"Ruby"',30,1,31
'"828713"','"website"','"10"',0,0,0,'"1223"','"Python"',139,0,139
'"828740"','"pgrouting-contrib"','"11"',0,1,1,'"1210"','"Java"',9,2,11
'"829725"','"django-remotestorage"','"21"',0,0,0,'"600"','"Python"',56,0,56
'"830225"','"ratbox"','"14"',0,0,0,'"913"','"Java"',12,0,12
'"831964"','"android_device_asus_tf700t"','"85"',17,0,17,'"537"','"Java"',369,0,369
'"832965"','"plexus-interpolation"','"31"',0,0,0,'"1143"','"Java"',104,0,104
'"834289"','"plone.app.testing"','"176"',25,0,25,'"893"','"Python"',182,5,187
'"834358"','"sauce-ondemand-plugin"','"306"',32,0,32,'"1179"','"Java"',236,2,238
'"834559"','"deploy"','"12"',0,0,0,'"625"','"Ruby"',24,5,29
'"838076"','"and2022"','"18"',0,0,0,'"651"','"Java"',13,1,14
'"840537"','"dgws"','"23"',0,0,0,'"693"','"Java"',105,8,113
'"842927"','"dry-run-plugin"','"292"',0,0,0,'"951"','"Java"',34,0,34
'"843331"','"slc.underflow"','"18"',0,0,0,'"536"','"Python"',30,0,30
'"845254"','"jenkins-validator-nu"','"17"',0,0,0,'"538"','"Java"',2,0,2
'"847372"','"canvas"','"10"',0,0,0,'"541"','"Ruby"',4,0,4
'"848789"','"tslib"','"14"',0,0,0,'"535"','"Python"',36,0,36
'"849728"','"subscriptions"','"59"',7,2,9,'"630"','"Python"',71,3,74
'"849787"','"nensskel"','"13"',0,0,0,'"912"','"Python"',175,2,177
'"849835"','"ftw.portlet.clock"','"14"',0,0,0,'"729"','"Python"',19,0,19
'"851408"','"routes-js"','"22"',0,0,0,'"645"','"Ruby"',8,0,8
'"852475"','"auslfe.formonline.content"','"12"',0,0,0,'"602"','"Python"',86,0,86
'"853157"','"nuxeo-tree-snapshot"','"22"',8,0,8,'"673"','"Java"',31,0,31
'"853316"','"slc.outdated"','"265"',0,0,0,'"1104"','"Python"',55,0,55
'"854482"','"rg_trainings"','"11"',0,0,0,'"535"','"Ruby"',11,0,11
'"855421"','"imagej1"','"11"',0,0,0,'"948"','"Java"',284,5,289
'"857354"','"guard-daemon"','"29"',0,0,0,'"535"','"Ruby"',10,0,10
'"857627"','"dagger"','"15"',22,8,30,'"581"','"Java"',482,237,719
'"857686"','"StoryBoard"','"11"',0,0,0,'"535"','"Ruby"',9,0,9
'"857907"','"PBS"','"17"',0,0,0,'"535"','"Ruby"',113,0,113
'"858413"','"sqs-connector"','"87"',10,0,10,'"860"','"Java"',99,5,104
'"858517"','"restful-api-uploader"','"24"',4,0,4,'"612"','"Ruby"',35,0,35
'"858850"','"dogstatsd-python"','"12"',0,0,0,'"630"','"Python"',35,6,41
'"863548"','"collective.ptg.presentation"','"266"',0,0,0,'"611"','"Python"',10,0,10
'"864979"','"naaya.chm"','"13"',0,0,0,'"939"','"Python"',288,0,288
'"865879"','"lizard-measure"','"13"',0,0,0,'"828"','"Python"',182,0,182
'"866741"','"collective.webservice"','"266"',0,0,0,'"534"','"Python"',25,0,25
'"866922"','"django-shipping"','"15"',0,0,0,'"534"','"Python"',52,0,52
'"867853"','"nuxeo-core-binarymanager-s3"','"22"',18,0,18,'"652"','"Java"',94,0,94
'"868811"','"static-resources-module"','"79"',0,0,0,'"534"','"Java"',7,0,7
'"869807"','"collective.portlet.tal"','"266"',0,0,0,'"534"','"Python"',11,0,11
'"870259"','"keyspace"','"78"',0,0,0,'"534"','"Ruby"',61,0,61
'"871649"','"adaptor-vmware"','"13"',0,0,0,'"600"','"Ruby"',660,27,687
'"874609"','"duckweed"','"25"',0,0,0,'"1035"','"Ruby"',98,0,98
'"875095"','"collective.behavior.localdiazo"','"266"',0,0,0,'"543"','"Python"',55,3,58
'"878031"','"101wiki"','"13"',0,0,0,'"533"','"Ruby"',108,0,108
'"878519"','"tornado"','"41"',15,2,17,'"1283"','"Python"',241,7,248
'"878533"','"StoreIDTopGateAPI"','"20"',0,0,0,'"881"','"Java"',36,0,36
'"879934"','"glamkit-adminboost"','"10"',0,0,0,'"1252"','"Python"',3,0,3
'"880093"','"base-configuration"','"28"',0,0,0,'"1060"','"Java"',20,0,20
'"880504"','"mule-module-protobuf"','"79"',0,0,0,'"538"','"Java"',11,1,12
'"882004"','"munit"','"82"',59,1,60,'"740"','"Java"',368,21,389
'"882150"','"django-bulk-export"','"14"',0,0,0,'"784"','"Python"',18,0,18
'"883252"','"liferayResourceEditor"','"13"',0,0,0,'"723"','"Java"',32,0,32
'"885101"','"qwirk_jms_adapter"','"16"',0,0,0,'"583"','"Ruby"',6,0,6
'"885112"','"qwirk_active_mq_adapter"','"16"',0,0,0,'"583"','"Ruby"',6,0,6
'"885130"','"qwirk_examples"','"16"',0,0,0,'"583"','"Ruby"',5,0,5
'"886077"','"gatein-rhq"','"15"',7,0,7,'"759"','"Java"',46,1,47
'"886136"','"build-cloud-tools"','"11"',67,0,67,'"535"','"Python"',240,0,240
'"886669"','"VersionOne.SDK.Python"','"23"',0,0,0,'"665"','"Python"',49,4,53
'"886843"','"plexus-components"','"31"',0,0,0,'"1220"','"Java"',92,0,92
'"887338"','"merchant-gateways"','"10"',0,0,0,'"1417"','"Python"',92,0,92
'"887914"','"SCTMExecutor-plugin"','"293"',0,0,0,'"1179"','"Java"',96,0,96
'"887963"','"configurationslicing-plugin"','"302"',0,0,0,'"1179"','"Java"',154,7,161
'"888838"','"vagrant-rubydev"','"24"',0,0,0,'"533"','"Ruby"',5,0,5
'"889277"','"transmogrify.wordpress"','"266"',0,0,0,'"540"','"Python"',13,0,13
'"889705"','"plone.tiles"','"176"',0,0,0,'"899"','"Python"',56,1,57
'"894492"','"collective.transform.kml"','"266"',0,0,0,'"635"','"Python"',12,0,12
'"894627"','"gaslight-podcast"','"12"',1,0,1,'"534"','"Ruby"',31,0,31
'"895664"','"buddycloud-test-suite"','"19"',0,0,0,'"654"','"Java"',34,9,43
'"896214"','"qwirk"','"17"',0,0,0,'"819"','"Ruby"',174,0,174
'"896266"','"luigi"','"101"',21,29,50,'"532"','"Python"',364,230,594
'"896679"','"redturtle.portlet.collection"','"11"',0,0,0,'"532"','"Python"',29,2,31
'"897127"','"beansbinding"','"10"',0,0,0,'"574"','"Java"',25,0,25
'"897132"','"belis-ee-server"','"10"',0,0,0,'"574"','"Java"',27,0,27
'"898949"','"lib-task-reactor"','"294"',0,0,0,'"1128"','"Java"',38,0,38
'"899594"','"sleepy"','"11"',0,0,0,'"956"','"Python"',108,48,156
'"899831"','"Activiti-Designer"','"11"',20,1,21,'"532"','"Java"',242,8,250
'"899943"','"dreamlive"','"10"',0,0,0,'"532"','"Ruby"',14,0,14
'"901270"','"bagheera-elasticsearch"','"16"',0,0,0,'"738"','"Java"',5,0,5
'"901786"','"nagios-plugins"','"10"',0,0,0,'"540"','"Python"',10,0,10
'"903142"','"homebrew-hekk"','"17"',4,0,4,'"619"','"Ruby"',12,0,12
'"904313"','"eco_apps"','"10"',0,0,0,'"1234"','"Ruby"',30,0,30
'"904336"','"eco_apps_auth"','"10"',0,0,0,'"1176"','"Ruby"',28,0,28
'"904414"','"eco_apps_util"','"10"',0,0,0,'"1176"','"Ruby"',6,0,6
'"906952"','"sitesetup"','"17"',0,0,0,'"849"','"Python"',110,0,110
'"907959"','"belis-client"','"10"',46,0,46,'"574"','"Java"',286,0,286
'"908009"','"cismet-application-commons"','"10"',0,0,0,'"574"','"Java"',12,0,12
'"908073"','"parallel_batch"','"14"',0,0,0,'"535"','"Ruby"',4,0,4
'"908735"','"collective.mockmailhost"','"268"',0,0,0,'"531"','"Python"',30,0,30
'"909351"','"nuxeo-platform-jbpm"','"22"',5,0,5,'"623"','"Java"',77,0,77
'"909507"','"collective.geolocationbehavior"','"268"',1,0,1,'"692"','"Python"',24,0,24
'"910445"','"stanbol-temis"','"22"',0,0,0,'"1106"','"Java"',48,0,48
'"910584"','"fire_poll"','"12"',0,0,0,'"1114"','"Ruby"',35,0,35
'"910907"','"This-Week-in-Open-Source"','"36"',0,0,0,'"923"','"Ruby"',13,0,13
'"913688"','"mule-common"','"79"',90,1,91,'"535"','"Java"',303,5,308
'"913924"','"collective.spotlight"','"268"',0,0,0,'"532"','"Python"',8,0,8
'"914064"','"documentation"','"12"',41,9,50,'"815"','"Ruby"',473,44,517
'"914078"','"api-v2-java-client"','"18"',0,0,0,'"567"','"Java"',9,0,9
'"914089"','"HorizontalImageScroller-Android"','"13"',0,0,0,'"532"','"Java"',35,4,39
'"914437"','"OpenTreeMap-iOS-skin"','"18"',0,0,0,'"531"','"Python"',3,0,3
'"914611"','"plone.locking"','"179"',0,0,0,'"897"','"Python"',77,1,78
'"919506"','"brasil.gov.barra"','"12"',4,0,4,'"530"','"Python"',58,2,60
'"919977"','"plone.app.tiles"','"179"',8,0,8,'"899"','"Python"',147,1,148
'"920960"','"Apple-Movie-Trailers.bundle"','"15"',0,0,0,'"1316"','"Python"',80,0,80
'"922873"','"plone.app.layoutpage"','"179"',0,0,0,'"850"','"Python"',31,0,31
'"923511"','"plone.app.imagetile"','"180"',0,0,0,'"850"','"Python"',34,0,34
'"925091"','"plone.app.texttile"','"180"',0,0,0,'"850"','"Python"',38,0,38
'"928141"','"buster-selenium"','"180"',0,0,0,'"529"','"Python"',69,0,69
'"930566"','"spokenvote"','"11"',28,8,36,'"529"','"Ruby"',399,272,671
'"930767"','"omniauth-kongregate"','"29"',0,0,0,'"529"','"Ruby"',9,1,10
'"930824"','"mopub-bidder"','"25"',0,0,0,'"981"','"Python"',5,0,5
'"931243"','"adhocracy"','"12"',309,75,384,'"529"','"Python"',4527,363,4890
'"934970"','"dhisreport"','"14"',4,0,4,'"533"','"Java"',47,0,47
'"936485"','"sdm4-ydelseimporter"','"20"',0,0,0,'"528"','"Java"',81,0,81
'"937073"','"lizard-shape"','"13"',2,0,2,'"716"','"Python"',101,0,101
'"937082"','"lizard-rainapp"','"13"',17,2,19,'"661"','"Python"',120,2,122
'"937905"','"escidoc-ijc"','"12"',0,0,0,'"554"','"Java"',118,0,118
'"940577"','"Ford"','"27"',1,0,1,'"591"','"Python"',101,1,102
'"940944"','"minimalplone4"','"268"',7,0,7,'"1255"','"Python"',17,0,17
'"941249"','"plone.app.themeeditor"','"182"',0,0,0,'"837"','"Python"',113,0,113
'"942158"','"kombinat.decogrid"','"268"',0,0,0,'"531"','"Python"',27,0,27
'"942176"','"collective.controlpanel.edit_css"','"268"',0,0,0,'"700"','"Python"',54,0,54
'"942499"','"collective.rip"','"268"',0,0,0,'"695"','"Python"',39,0,39
'"942517"','"chef-node"','"13"',0,0,0,'"528"','"Ruby"',4,0,4
'"942557"','"edr"','"16"',0,0,0,'"528"','"Ruby"',7,3,10
'"942610"','"collective.superfish"','"268"',0,0,0,'"531"','"Python"',33,1,34
'"944137"','"python-zuora"','"10"',41,2,43,'"531"','"Python"',179,3,182
'"944594"','"aprende.a.programar"','"13"',0,0,0,'"649"','"Ruby"',33,3,36
'"948899"','"collective.xmpp.collaboration"','"268"',0,0,0,'"528"','"Python"',21,0,21
'"951003"','"lizard-graph"','"13"',0,0,0,'"847"','"Python"',97,0,97
'"952144"','"appcontext"','"28"',0,0,0,'"1060"','"Java"',66,0,66
'"952264"','"xwiki-glimpse"','"17"',0,0,0,'"882"','"Java"',31,3,34
'"952465"','"join.agiliq.com"','"12"',0,0,0,'"527"','"Python"',61,0,61
'"952794"','"collective.ptg.s3slider"','"270"',0,0,0,'"611"','"Python"',15,0,15
'"953346"','"lizard-fewsunblobbed"','"13"',13,0,13,'"661"','"Python"',121,0,121
'"954476"','"singly-android"','"16"',1,0,1,'"540"','"Java"',36,27,63
'"954912"','"http-client"','"14"',14,2,16,'"996"','"Java"',104,3,107
'"955324"','"django-fitbit"','"11"',0,0,0,'"614"','"Python"',70,7,77
'"956098"','"virt-test"','"25"',507,155,662,'"527"','"Python"',4192,1255,5447
'"956558"','"async-http-client-plugin"','"295"',0,1,1,'"695"','"Java"',19,2,21
'"957168"','"leptoid"','"23"',0,0,0,'"527"','"Python"',2,0,2
'"958709"','"epuagent"','"37"',0,0,0,'"1084"','"Python"',72,0,72
'"959915"','"ranguba"','"15"',9,0,9,'"1351"','"Ruby"',120,0,120
'"961358"','"jubatus-python-client"','"14"',4,1,5,'"863"','"Python"',97,17,114
'"963414"','"CFUTV"','"11"',0,0,0,'"568"','"Java"',12,0,12
'"963805"','"bi-etl"','"12"',0,0,0,'"559"','"Java"',6,0,6
'"964369"','"wlan-poller"','"11"',0,0,0,'"528"','"Ruby"',27,0,27
'"965293"','"limbo"','"13"',0,0,0,'"612"','"Ruby"',17,0,17
'"965571"','"build-scripts"','"18"',0,0,0,'"735"','"Java"',89,0,89
'"966338"','"Products.Reportek"','"12"',0,0,0,'"664"','"Python"',93,0,93
'"967533"','"ZenPacks.zenoss.Puppet"','"20"',0,0,0,'"897"','"Python"',8,0,8
'"968116"','"django-webauth"','"11"',0,0,0,'"739"','"Python"',34,6,40
'"968439"','"cppwrap-maven-plugin"','"11"',12,0,12,'"664"','"Java"',49,0,49
'"969064"','"spar"','"13"',0,0,0,'"701"','"Ruby"',43,11,54
'"971689"','"simplicity"','"19"',0,0,0,'"526"','"Python"',3,0,3
'"971922"','"nodule"','"21"',0,0,0,'"734"','"Ruby"',97,0,97
'"972779"','"CheddarClient"','"15"',0,0,0,'"1067"','"Java"',69,3,72
'"974484"','"openmrs-module-auditlog"','"11"',0,0,0,'"525"','"Java"',110,0,110
'"976139"','"collective.hootsuite"','"271"',0,0,0,'"527"','"Python"',3,0,3
'"978319"','"dari"','"44"',76,1,77,'"526"','"Java"',973,3,976
'"978965"','"brightspot-cms"','"44"',309,0,309,'"526"','"Java"',1939,1,1940
'"984166"','"rack-key_value_logger"','"24"',0,0,0,'"640"','"Ruby"',39,2,41
'"984967"','"Yousee_Ingest_Reporter"','"11"',0,0,0,'"638"','"Python"',24,0,24
'"985450"','"ItInTheD"','"18"',0,0,0,'"616"','"Ruby"',237,1,238
'"987464"','"hashboard"','"78"',0,0,0,'"937"','"Ruby"',2,0,2
'"988294"','"swift"','"17"',7,13,20,'"666"','"Java"',206,148,354
'"989679"','"SDKs"','"32"',0,0,0,'"903"','"Java"',76,7,83
'"990455"','"django-cms-dbtemplates"','"42"',16,3,19,'"883"','"Python"',198,20,218
'"992166"','"hello-spring-mysql"','"15"',0,0,0,'"689"','"Java"',8,0,8
'"992781"','"templer.buildout"','"271"',0,0,0,'"710"','"Python"',28,0,28
'"993487"','"vcs-bridge-plugin"','"12"',0,0,0,'"856"','"Java"',18,0,18
'"994243"','"Products.NaayaGlossary"','"13"',3,0,3,'"779"','"Python"',64,0,64
'"994784"','"urmp"','"11"',1,0,1,'"951"','"Ruby"',224,5,229
'"995285"','"ome-versioning"','"11"',11,0,11,'"553"','"Java"',13,0,13
'"997164"','"styleguide"','"32"',0,0,0,'"524"','"Ruby"',9,0,9
'"998807"','"ps-scripts"','"11"',0,0,0,'"812"','"Java"',73,0,73
'"999306"','"interactive-self-assessment"','"10"',0,0,0,'"748"','"Java"',51,0,51
'"1001609"','"RecyclerGameJava"','"11"',0,0,0,'"523"','"Java"',25,0,25
'"1002110"','"collective.exampledevtools"','"271"',0,0,0,'"524"','"Python"',9,0,9
'"1002573"','"etm-agent"','"11"',0,0,0,'"854"','"Java"',7,0,7
'"1003929"','"playground"','"14"',0,0,0,'"522"','"Java"',45,0,45
'"1006690"','"jelly"','"295"',0,0,0,'"1492"','"Java"',65,0,65
'"1007999"','"ant-interceptor"','"295"',0,0,0,'"523"','"Java"',9,0,9
'"1008127"','"penncoursereview-sdk-python"','"11"',0,0,0,'"523"','"Python"',14,2,16
'"1009808"','"MESS-Documentation"','"14"',0,0,0,'"522"','"Python"',5,0,5
'"1010951"','"gitlab"','"10"',0,0,0,'"522"','"Ruby"',13,0,13
'"1012770"','"collective.gazette"','"271"',0,0,0,'"763"','"Python"',18,0,18
'"1016867"','"python-sword2"','"16"',0,0,0,'"787"','"Python"',46,0,46
'"1017482"','"linkscape-py"','"54"',0,0,0,'"682"','"Python"',7,1,8
'"1017909"','"openmrs-module-dictionarysubscribing"','"11"',0,0,0,'"523"','"Java"',6,3,9
'"1018994"','"HealthOffice"','"23"',0,0,0,'"623"','"Java"',142,0,142
'"1020354"','"collective.js.underscore"','"271"',1,0,1,'"609"','"Python"',11,2,13
'"1020818"','"rails-emoji"','"31"',0,0,0,'"596"','"Ruby"',23,1,24
'"1021755"','"FwDocumentation"','"14"',0,0,0,'"546"','"Java"',7,0,7
'"1021876"','"astrotaverna"','"25"',30,1,31,'"694"','"Java"',234,1,235
'"1022034"','"OOB"','"11"',0,0,0,'"521"','"Java"',2,0,2
'"1022151"','"collective.cron"','"272"',0,0,0,'"724"','"Python"',39,7,46
'"1022394"','"lizard-registration"','"13"',0,0,0,'"759"','"Python"',57,0,57
'"1022545"','"idea-templates"','"11"',0,0,0,'"524"','"Java"',72,0,72
'"1023176"','"embedded-jboss-maven-plugin"','"33"',0,0,0,'"882"','"Java"',104,0,104
'"1023462"','"io"','"15"',0,0,0,'"726"','"Python"',5,0,5
'"1023559"','"Koztumize"','"13"',0,0,0,'"839"','"Python"',209,1,210
'"1023853"','"vo-param"','"24"',12,0,12,'"521"','"Java"',141,0,141
'"1024277"','"rayo-functional-tests"','"27"',0,0,0,'"917"','"Java"',136,0,136
'"1024498"','"Project-Arena-Server"','"35"',0,0,0,'"750"','"Java"',19,1,20
'"1025090"','"rayo-load-tests"','"23"',0,0,0,'"916"','"Python"',24,0,24
'"1025093"','"rayo-java-client"','"23"',0,0,0,'"916"','"Java"',92,0,92
'"1025098"','"deployed-on-column-plugin"','"294"',0,0,0,'"521"','"Java"',17,0,17
'"1025412"','"i18ndude"','"272"',3,1,4,'"521"','"Python"',157,2,159
'"1025927"','"invitable"','"15"',0,0,0,'"706"','"Ruby"',11,0,11
'"1026345"','"XinCheJian-Door"','"21"',0,0,0,'"907"','"Java"',20,0,20
'"1026372"','"rascal-shell"','"16"',3,0,3,'"591"','"Java"',42,0,42
'"1026562"','"artisan_api"','"39"',0,0,0,'"941"','"Ruby"',89,2,91
'"1026880"','"jamppa"','"19"',0,0,0,'"521"','"Java"',3,0,3
'"1026925"','"collective.soundcloud"','"272"',0,0,0,'"897"','"Python"',83,0,83
'"1028405"','"origin-dev-tools"','"155"',27,22,49,'"532"','"Ruby"',205,130,335
'"1033754"','"Products.LDAPUserFolder"','"13"',0,0,0,'"520"','"Python"',18,0,18
'"1034023"','"formash"','"10"',0,0,0,'"528"','"Ruby"',6,0,6
'"1034559"','"collective.portlet.shelf"','"272"',5,0,5,'"762"','"Python"',51,0,51
'"1037595"','"com.idega.hibernate"','"10"',0,0,0,'"1712"','"Java"',91,0,91
'"1039679"','"ooo-util"','"15"',2,0,2,'"883"','"Java"',38,0,38
'"1039978"','"rhaptos2.user"','"18"',0,0,0,'"553"','"Python"',106,10,116
'"1042189"','"webpay"','"30"',93,34,127,'"521"','"Python"',782,402,1184
'"1042276"','"katas"','"11"',0,0,0,'"897"','"Ruby"',7,0,7
'"1088384"','"flamaster"','"22"',0,0,0,'"791"','"Python"',1099,126,1225
'"1097375"','"wimms"','"11"',9,1,10,'"734"','"Python"',63,2,65
'"1149656"','"view-janiculum"','"13"',0,0,0,'"1011"','"Java"',168,0,168
'"1164618"','"EmailValidator"','"18"',0,0,0,'"685"','"Java"',0,0,0
'"1168893"','"dawn-edna"','"12"',0,0,0,'"779"','"Java"',8,0,8
'"1195359"','"OpenCV"','"10"',19,0,19,'"750"','"Python"',162,0,162
'"1199766"','"stages"','"11"',9,1,10,'"784"','"Ruby"',115,4,119
'"1205268"','"lib-jenkins-maven-embedder"','"298"',0,0,0,'"1128"','"Java"',122,2,124
'"1215417"','"sbt-plugin"','"301"',0,0,0,'"1156"','"Java"',38,8,46
'"1215468"','"Catroid-maven-playground"','"96"',0,0,0,'"659"','"Java"',9,0,9
'"1232293"','"csc-utils"','"34"',0,0,0,'"1434"','"Python"',79,0,79
'"1241464"','"redak"','"23"',0,0,0,'"656"','"Java"',68,0,68
'"1282139"','"chaojia_weibo"','"11"',0,0,0,'"634"','"Python"',0,0,0
'"1292559"','"documentation"','"167"',147,39,186,'"496"','"Python"',862,162,1024
'"1300378"','"cs373-pfd-tests"','"37"',0,0,0,'"631"','"Python"',0,0,0
'"1303623"','"Yet-Another-Calendar"','"10"',0,0,0,'"653"','"Java"',311,0,311
'"1336946"','"twitlist"','"15"',0,0,0,'"658"','"Ruby"',20,0,20
'"1340285"','"log4j-email-throttle"','"75"',0,0,0,'"931"','"Java"',15,0,15
'"1344612"','"scikit-image"','"12"',26,24,50,'"973"','"Python"',1188,692,1880
'"1344878"','"chef-docs"','"75"',568,9,577,'"605"','"Python"',3301,182,3483
'"1345655"','"dino"','"11"',4,2,6,'"539"','"Ruby"',154,40,194
'"1347553"','"origin-server"','"139"',801,457,1258,'"684"','"Ruby"',7014,4836,11850
'"1350393"','"druid"','"20"',319,48,367,'"499"','"Java"',2529,286,2815
'"1351954"','"celdas7568"','"13"',0,0,0,'"481"','"Java"',5,0,5
'"1358732"','"qiime"','"28"',19,22,41,'"508"','"Python"',3767,500,4267
'"1361512"','"pyrax"','"12"',31,19,50,'"525"','"Python"',488,126,614
'"1361725"','"do-hana-adapter"','"10"',0,0,0,'"486"','"Ruby"',35,0,35
'"1363086"','"sched.do"','"263"',0,0,0,'"645"','"Ruby"',2262,389,2651
'"1363159"','"python2012"','"31"',0,0,0,'"491"','"Python"',20,3,23
'"1363661"','"B51"','"11"',0,0,0,'"506"','"Python"',125,0,125
'"1364863"','"simple_deploy"','"11"',4,2,6,'"633"','"Ruby"',509,108,617
'"1366147"','"neo4j"','"29"',316,220,536,'"479"','"Java"',7057,1253,8310
'"1366976"','"hank"','"10"',16,2,18,'"1126"','"Java"',473,13,486
'"1367511"','"plugin-content-import-export"','"27"',0,0,0,'"492"','"Java"',16,0,16
'"1368794"','"budget"','"10"',0,0,0,'"493"','"Ruby"',226,14,240
'"1369701"','"conda"','"26"',0,0,0,'"507"','"Python"',1675,51,1726
'"1370899"','"frontend"','"14"',0,0,0,'"502"','"Java"',140,0,140
'"1371771"','"oai_repository"','"24"',0,0,0,'"639"','"Ruby"',22,1,23
'"1373119"','"TallerII"','"19"',0,0,0,'"541"','"Java"',49,0,49
'"1374387"','"election_screenshot"','"14"',0,0,0,'"490"','"Python"',52,0,52
'"1374960"','"testEGit"','"41"',0,0,0,'"502"','"Java"',75,0,75
'"1378066"','"24pullrequests"','"12"',5,0,5,'"478"','"Ruby"',1106,401,1507
'"1379693"','"build-buildbotcustom"','"11"',51,0,51,'"510"','"Python"',629,0,629
'"1380741"','"templeton"','"17"',0,0,0,'"995"','"Python"',29,0,29
'"1380764"','"django-piston"','"11"',0,0,0,'"800"','"Python"',272,0,272
'"1380983"','"sortingmadness"','"10"',0,0,0,'"504"','"Python"',35,0,35
'"1381021"','"gitlab-ci"','"14"',95,14,109,'"512"','"Ruby"',423,149,572
'"1391370"','"build-mozharness"','"11"',150,0,150,'"503"','"Python"',942,0,942
'"1392342"','"backlot-ingestion-library"','"21"',0,0,0,'"485"','"Ruby"',16,5,21
'"1392392"','"VoxelGunsmith"','"11"',0,0,0,'"498"','"Java"',17,0,17
'"1392964"','"kijiproject.github.com"','"18"',13,0,13,'"477"','"Ruby"',410,103,513
'"1393059"','"kiji-schema"','"18"',22,0,22,'"477"','"Java"',526,198,724
'"1393874"','"imvujs"','"62"',19,0,19,'"622"','"Python"',610,1,611
'"1397979"','"aws-sdk-ruby"','"22"',44,17,61,'"966"','"Ruby"',717,262,979
'"1401913"','"Android"','"10"',0,0,0,'"476"','"Java"',1,0,1
'"1403672"','"NewTech"','"17"',51,1,52,'"477"','"Ruby"',446,14,460
'"1404576"','"crowdculture"','"35"',0,0,0,'"503"','"Ruby"',57,0,57
'"1407150"','"CampusHunter"','"11"',0,0,0,'"517"','"Ruby"',360,0,360
'"1408720"','"django-oscar-parachute"','"10"',0,0,0,'"574"','"Python"',10,0,10
'"1412520"','"project-buildout"','"14"',0,0,0,'"689"','"Python"',12,3,15
'"1413489"','"sonar-l10n-pt"','"25"',0,0,0,'"519"','"Java"',42,1,43
'"1416998"','"ftw.publisher-example-buildout"','"14"',0,0,0,'"1071"','"Python"',25,0,25
'"1420893"','"NuxeoTraining"','"22"',33,0,33,'"636"','"Java"',295,8,303
'"1422405"','"pan"','"10"',0,0,0,'"492"','"Java"',323,3,326
'"1422713"','"Grinnell-Menu"','"10"',16,0,16,'"876"','"Java"',118,0,118
'"1426743"','"i-takehiro"','"16"',0,0,0,'"520"','"Java"',29,0,29
'"1426802"','"quest"','"18"',11,0,11,'"511"','"Java"',311,1,312
'"1429756"','"youseeingestinitiator"','"10"',0,0,0,'"667"','"Java"',77,0,77
'"1430816"','"eea.versions"','"16"',14,0,14,'"519"','"Python"',18,0,18
'"1431761"','"unutopia-android"','"10"',0,0,0,'"512"','"Java"',218,0,218
'"1432013"','"collective.richdescription"','"309"',0,0,0,'"1247"','"Python"',19,0,19
'"1432951"','"VoxelBorder"','"11"',0,0,0,'"491"','"Java"',19,0,19
'"1433342"','"ftw.contentpage"','"19"',57,10,67,'"492"','"Python"',784,125,909
'"1433462"','"collective.ptg.simplegallery"','"309"',0,0,0,'"492"','"Python"',25,0,25
'"1433835"','"akvo-docs"','"15"',0,0,0,'"497"','"Python"',28,0,28
'"1434223"','"VoxelGadget"','"11"',0,0,0,'"491"','"Java"',4,2,6
'"1437027"','"foorder"','"14"',0,0,0,'"525"','"Ruby"',25,0,25
'"1437066"','"dojos"','"12"',36,0,36,'"489"','"Java"',188,0,188
'"1438060"','"sonar-l10n-zh"','"25"',6,0,6,'"519"','"Java"',67,0,67
'"1438440"','"irof"','"16"',0,0,0,'"520"','"Java"',17,0,17
'"1439122"','"collective.itvalidators"','"11"',0,0,0,'"484"','"Python"',23,0,23
'"1441671"','"HPeriodFiles"','"16"',0,0,0,'"510"','"Java"',34,0,34
'"1442914"','"next-executions-plugin"','"299"',8,1,9,'"1003"','"Java"',75,2,77
'"1443265"','"CNC_Model"','"14"',0,0,0,'"494"','"Java"',67,0,67
'"1443291"','"akvo-flow-docs"','"14"',13,0,13,'"742"','"Python"',398,0,398
'"1444617"','"git-duet"','"49"',5,1,6,'"499"','"Ruby"',128,8,136
'"1448496"','"cookcountyjail"','"10"',15,15,30,'"472"','"Python"',241,148,389
'"1448838"','"marketplace-csv"','"22"',2,0,2,'"538"','"Java"',17,0,17
'"1449561"','"mxit_api"','"28"',0,0,0,'"492"','"Ruby"',16,0,16
'"1450160"','"vertx-plugin"','"298"',0,0,0,'"471"','"Java"',11,0,11
'"1450622"','"sonar-l10n-fr"','"26"',0,0,0,'"519"','"Java"',102,0,102
'"1450809"','"timeseries"','"17"',0,0,0,'"877"','"Python"',282,0,282
'"1450935"','"SS_test"','"15"',0,0,0,'"484"','"Java"',4,0,4
'"1451294"','"pas.plugins.ldap"','"309"',5,0,5,'"1298"','"Python"',213,0,213
'"1451629"','"eea.daviz"','"16"',6,0,6,'"519"','"Python"',13,2,15
'"1451777"','"eea.app.visualization"','"16"',0,0,0,'"519"','"Python"',174,2,176
'"1451862"','"eea.forms"','"16"',0,0,0,'"519"','"Python"',1,2,3
'"1452397"','"eea.sparql"','"16"',1,0,1,'"519"','"Python"',1,0,1
'"1452613"','"eea.relations"','"16"',8,0,8,'"519"','"Python"',224,1,225
'"1452631"','"eea.converter"','"16"',0,0,0,'"519"','"Python"',1,0,1
'"1452664"','"eea.cache"','"16"',0,0,0,'"519"','"Python"',0,0,0
'"1453211"','"keystone"','"26"',1,0,1,'"617"','"Ruby"',4,1,5
'"1457056"','"uc-iic2113-20122"','"14"',0,0,0,'"568"','"Java"',1,0,1
'"1464858"','"copy2clipboard"','"50"',0,0,0,'"619"','"Java"',23,0,23
'"1467501"','"chef-sumologic"','"13"',1,1,2,'"483"','"Ruby"',23,8,31
'"1470517"','"TDH-dc24-ingester-platform"','"12"',0,0,0,'"514"','"Python"',176,0,176
'"1470777"','"SCORMCloud_JavaLibrary"','"14"',3,1,4,'"1112"','"Java"',49,5,54
'"1471030"','"static-kick"','"19"',0,0,0,'"652"','"Python"',6,0,6
'"1471130"','"jcu.dc24.ingesterapi"','"12"',0,0,0,'"507"','"Python"',112,0,112
'"1471774"','"koborutaru"','"10"',0,0,0,'"598"','"Ruby"',67,0,67
'"1476710"','"highrise_assist"','"24"',0,0,0,'"842"','"Ruby"',12,0,12
'"1480984"','"virtualmaster-api"','"11"',0,0,0,'"550"','"Ruby"',30,0,30
'"1481029"','"openmultimedia.utils"','"23"',0,0,0,'"536"','"Python"',44,0,44
'"1482801"','"google-maps"','"13"',0,0,0,'"890"','"Ruby"',23,2,25
'"1483314"','"neb2activemq"','"12"',0,0,0,'"1464"','"Python"',166,0,166
'"1486201"','"DaltonA2012"','"12"',0,0,0,'"510"','"Java"',25,0,25
'"1487470"','"youseeepgdownloader"','"10"',0,0,0,'"496"','"Python"',38,0,38
'"1491519"','"codebase-cli"','"24"',0,0,0,'"517"','"Ruby"',14,0,14
'"1492028"','"Bedpres"','"17"',0,0,0,'"507"','"Ruby"',416,1,417
'"1492792"','"wildcard.level3caching"','"310"',0,0,0,'"483"','"Python"',26,0,26
'"1496428"','"zojax.content.discussion"','"15"',2,0,2,'"968"','"Python"',60,0,60
'"1499318"','"factual-android-sdk-demo"','"10"',0,0,0,'"661"','"Java"',8,0,8
'"1499992"','"ruby-quilt"','"21"',0,0,0,'"681"','"Ruby"',49,0,49
'"1500216"','"hutch"','"11"',0,0,0,'"861"','"Python"',11,1,12
'"1501197"','"voltdb-labs"','"15"',0,0,0,'"514"','"Java"',54,5,59
'"1502958"','"ftw.participation"','"14"',42,3,45,'"826"','"Python"',240,21,261
'"1503167"','"ENdoSnipe"','"30"',39,23,62,'"483"','"Java"',588,247,835
'"1504669"','"junit-tools"','"12"',0,0,0,'"605"','"Java"',13,0,13
'"1504740"','"webview"','"20"',321,34,355,'"601"','"Python"',1774,225,1999
'"1505323"','"openmdao_testapp"','"13"',0,0,0,'"918"','"Python"',115,2,117
'"1505763"','"sisu-maven-plugin"','"28"',5,0,5,'"1101"','"Java"',27,0,27
'"1507229"','"coup"','"52"',0,0,0,'"1135"','"Ruby"',82,0,82
'"1509503"','"django-paginav"','"12"',0,0,0,'"1058"','"Python"',3,0,3
'"1510742"','"BD_Tool"','"11"',0,0,0,'"632"','"Java"',7,0,7
'"1511196"','"django-tutorial-jacob"','"11"',0,0,0,'"605"','"Python"',30,0,30
'"1511692"','"immunity_integration_test_app"','"24"',0,0,0,'"601"','"Ruby"',4,0,4
'"1513592"','"kupu"','"310"',0,0,0,'"484"','"Python"',330,0,330
'"1514103"','"fmk-vagrant-chef"','"23"',0,0,0,'"767"','"Ruby"',83,0,83
'"1514365"','"play-chat"','"15"',0,0,0,'"688"','"Java"',2,0,2
'"1515890"','"silktestsuite-plugin"','"298"',0,0,0,'"807"','"Java"',16,0,16
'"1516061"','"Bergen-Maps"','"12"',0,0,0,'"749"','"Java"',113,0,113
'"1516771"','"collective.anysurfer"','"10"',0,0,0,'"484"','"Python"',9,0,9
'"1517998"','"plivo-java"','"10"',42,0,42,'"899"','"Java"',271,8,279
'"1518624"','"rubyfox-sfsobject"','"10"',0,0,0,'"489"','"Ruby"',44,1,45
'"1519480"','"email-reports"','"17"',0,0,0,'"973"','"Python"',53,3,56
'"1519954"','"hobo_paperclip"','"11"',0,0,0,'"515"','"Ruby"',12,0,12
'"1520396"','"com.idega.block.calendar"','"10"',0,0,0,'"1688"','"Java"',194,0,194
'"1520616"','"com.idega.block.entity"','"10"',0,0,0,'"1712"','"Java"',288,0,288
'"1520748"','"Programacion2_2_4_2012"','"14"',0,0,0,'"509"','"Java"',28,0,28
'"1520779"','"com.idega.block.image"','"10"',0,0,0,'"1712"','"Java"',235,0,235
'"1521226"','"com.idega.block.login"','"11"',8,0,8,'"1712"','"Java"',332,0,332
'"1521834"','"collective.contextimage"','"310"',0,0,0,'"1009"','"Python"',44,0,44
'"1522982"','"navPlugin"','"10"',6,0,6,'"615"','"Java"',54,0,54
'"1524026"','"com.idega.manager"','"10"',0,0,0,'"1712"','"Java"',187,0,187
'"1524683"','"Products.CMFBibliographyAT"','"310"',0,0,0,'"490"','"Python"',272,0,272
'"1524855"','"odata-connector"','"79"',0,0,0,'"588"','"Java"',46,0,46
'"1525185"','"SCORMCloud_JavaDemoApp"','"14"',0,1,1,'"1111"','"Java"',6,1,7
'"1525342"','"launchd-slave-installer-module"','"299"',0,0,0,'"510"','"Java"',22,0,22
'"1528579"','"21M359Fall2012"','"13"',0,0,0,'"471"','"Python"',20,1,21
'"1530161"','"stewie"','"75"',0,0,0,'"686"','"Python"',65,0,65
'"1531200"','"sojo-det"','"12"',0,0,0,'"665"','"Java"',5,0,5
'"1533497"','"google-connectors-suite"','"85"',21,1,22,'"482"','"Java"',291,3,294
'"1536439"','"City-Go-Round"','"10"',0,0,0,'"1575"','"Python"',311,0,311
'"1536748"','"MyHostel"','"11"',0,0,0,'"604"','"Java"',46,0,46
'"1536910"','"ScratchToCatrobat"','"96"',0,0,0,'"654"','"Python"',15,1,16
'"1538137"','"energy2d"','"10"',0,0,0,'"997"','"Java"',289,0,289
'"1539088"','"windfarm-genco"','"12"',0,0,0,'"658"','"Java"',19,0,19
'"1543354"','"omniauth-passport"','"15"',0,0,0,'"639"','"Ruby"',34,5,39
'"1543723"','"MyGithub"','"12"',0,0,0,'"462"','"Java"',3,0,3
'"1545090"','"quark-java"','"30"',0,0,0,'"750"','"Java"',114,1,115
'"1545158"','"ftw.mopage"','"14"',0,0,0,'"751"','"Python"',51,0,51
'"1545591"','"openproject"','"18"',1657,204,1861,'"463"','"Ruby"',11723,992,12715
'"1545878"','"bidmc-initech"','"13"',0,0,0,'"463"','"Ruby"',4,0,4
'"1547189"','"oauned"','"21"',0,0,0,'"1162"','"Ruby"',61,0,61
'"1550050"','"opencredo-esper"','"10"',0,0,0,'"1540"','"Java"',90,0,90
'"1550403"','"tboxanalysis"','"38"',0,0,0,'"629"','"Ruby"',38,1,39
'"1553540"','"hellodjango"','"15"',0,0,0,'"688"','"Python"',2,0,2
'"1554292"','"manybots-instagram"','"11"',0,0,0,'"690"','"Ruby"',4,0,4
'"1554421"','"EngineeringChallenges"','"17"',0,0,0,'"910"','"Ruby"',17,0,17
'"1558281"','"mule-module-validation"','"80"',0,0,0,'"743"','"Java"',6,0,6
'"1561176"','"rhok-plan-generator"','"13"',42,0,42,'"460"','"Ruby"',306,9,315
'"1562776"','"sbhx-snippets"','"29"',2,0,2,'"1158"','"Ruby"',251,0,251
'"1565122"','"pydocgen"','"10"',0,0,0,'"737"','"Python"',136,0,136
'"1570824"','"chef-socorro"','"10"',0,0,0,'"615"','"Ruby"',35,0,35
'"1572949"','"ij1-tests"','"18"',7,0,7,'"717"','"Java"',59,0,59
'"1574632"','"nv3_deps"','"12"',0,0,0,'"665"','"Python"',23,0,23
'"1576622"','"liszt"','"15"',0,0,0,'"896"','"Ruby"',36,1,37
'"1579351"','"iVoted2012"','"21"',0,0,0,'"506"','"Ruby"',124,0,124
'"1584289"','"naaya.content.bfile"','"13"',2,0,2,'"779"','"Python"',118,0,118
'"1585080"','"JCU-Collaborative-Research-Portal"','"13"',0,0,0,'"611"','"Ruby"',154,0,154
'"1587108"','"dependency-queue-plugin"','"301"',0,0,0,'"657"','"Java"',12,0,12
'"1589076"','"myna_bird"','"13"',3,1,4,'"1232"','"Ruby"',48,1,49
'"1590072"','"serenity-plugin"','"301"',0,0,0,'"1179"','"Java"',156,0,156
'"1590249"','"stokenserver"','"11"',0,0,0,'"735"','"Python"',41,0,41
'"1591824"','"propane-overrides"','"23"',0,0,0,'"603"','"Ruby"',4,0,4
'"1592080"','"jubatus-tutorial-python"','"14"',0,0,0,'"850"','"Python"',11,1,12
'"1592149"','"vilya"','"16"',0,0,0,'"1065"','"Java"',312,0,312
'"1593882"','"tdh.metadata"','"11"',0,0,0,'"647"','"Python"',207,0,207
'"1594756"','"nexus-request-interceptor-plugin"','"28"',0,0,0,'"1017"','"Java"',27,0,27
'"1594914"','"testduplicates"','"45"',0,0,0,'"1521"','"Python"',30,0,30
'"1597616"','"auth-deploy"','"12"',0,0,0,'"777"','"Ruby"',35,0,35
'"1598460"','"SpaceFortress"','"12"',0,0,0,'"756"','"Python"',326,0,326
'"1598597"','"SaccadeTask"','"12"',0,0,0,'"756"','"Python"',84,0,84
'"1605007"','"unisubs-testing"','"12"',0,0,0,'"1356"','"Python"',301,0,301
'"1607392"','"jira-jenkins-plugin"','"53"',0,0,0,'"764"','"Java"',61,0,61
'"1607462"','"grima"','"14"',0,0,0,'"1308"','"Python"',303,0,303
'"1608927"','"fr.obeo.sonar.plugin.regexfilefilter"','"10"',0,0,0,'"594"','"Java"',6,0,6
'"1611658"','"MakeAPI"','"26"',34,13,47,'"469"','"Python"',264,196,460
'"1614332"','"AndroidNotes"','"20"',0,0,0,'"1232"','"Java"',8,0,8
'"1620801"','"devst_awaji_judgeman"','"26"',0,0,0,'"724"','"Java"',42,0,42
'"1622115"','"multi_http"','"11"',0,0,0,'"805"','"Ruby"',5,0,5
'"1626517"','"oauth2-rails-demo"','"16"',0,0,0,'"689"','"Ruby"',29,0,29
'"1628932"','"jas"','"15"',0,0,0,'"868"','"Java"',37,0,37
'"1629224"','"django-bu-cas"','"14"',0,0,0,'"730"','"Python"',25,0,25
'"1629727"','"sslackey"','"15"',0,0,0,'"597"','"Ruby"',9,1,10
'"1630826"','"sinatra-rabbitmq"','"15"',0,0,0,'"689"','"Ruby"',3,0,3
'"1631869"','"groupme-android-sdk"','"22"',0,0,0,'"1021"','"Java"',17,0,17
'"1633653"','"airbrake4j"','"26"',0,0,0,'"1108"','"Java"',46,0,46
'"1635887"','"ella-series"','"11"',0,0,0,'"780"','"Python"',5,0,5
'"1637730"','"RZGithubUtils"','"18"',0,0,0,'"590"','"Python"',2,0,2
'"1639388"','"icinga"','"50"',175,10,185,'"525"','"Ruby"',668,105,773
'"1654917"','"collective.cdn.multiplehostnames"','"323"',0,0,0,'"819"','"Python"',15,0,15
'"1666668"','"plone.registry"','"235"',0,0,0,'"897"','"Python"',64,2,66
'"1667403"','"net-o-meter"','"11"',0,0,0,'"501"','"Python"',63,0,63
'"1667881"','"RapidFTR---Android"','"23"',0,0,0,'"1430"','"Java"',181,116,297
'"1678924"','"ecologylabSemanticService"','"12"',0,0,0,'"510"','"Java"',66,0,66
'"1686129"','"faraday-http-cache"','"28"',23,2,25,'"758"','"Ruby"',217,17,234
'"1711636"','"cat"','"14"',12,11,23,'"456"','"Java"',919,213,1132
'"1722714"','"socnetapi"','"11"',0,0,0,'"1029"','"Ruby"',141,1,142
'"1756850"','"alfresco-android-app"','"31"',16,15,31,'"570"','"Java"',259,183,442
'"1765844"','"office_styles"','"24"',0,0,0,'"1170"','"Ruby"',8,0,8
'"1765860"','"thirtythirty"','"24"',0,0,0,'"1127"','"Ruby"',36,0,36
'"1765979"','"snippr"','"25"',4,0,4,'"1406"','"Ruby"',177,0,177
'"1767340"','"kraut"','"24"',0,0,0,'"1242"','"Ruby"',77,0,77
'"1791841"','"zmote-server"','"19"',0,0,0,'"492"','"Ruby"',109,0,109
'"1802399"','"secret_sauce"','"55"',0,0,0,'"480"','"Python"',3,0,3
'"1802888"','"issuu"','"27"',0,0,0,'"1157"','"Ruby"',60,1,61
'"1802931"','"wordy"','"27"',0,0,0,'"694"','"Ruby"',38,0,38
'"1803672"','"mule"','"39"',508,170,678,'"454"','"Java"',14975,432,15407
'"1834059"','"classy_field_errors"','"19"',0,0,0,'"1591"','"Ruby"',1,0,1
'"1835805"','"devst_awaji_wildboar"','"26"',0,0,0,'"707"','"Java"',1,0,1
'"1836297"','"nuxeo-ide"','"22"',2,0,2,'"504"','"Java"',361,3,364
'"1836873"','"website"','"79"',0,0,0,'"453"','"Python"',544,451,995
'"1845691"','"SplashScreen"','"15"',0,0,0,'"503"','"Java"',66,0,66
'"1855535"','"dc18a"','"25"',0,0,0,'"583"','"Ruby"',223,1,224
'"1863670"','"jsr107tck"','"12"',0,0,0,'"1022"','"Java"',514,10,524
'"1871929"','"threedilib"','"16"',3,0,3,'"499"','"Python"',76,0,76
'"1876064"','"collective.hashtags"','"14"',0,0,0,'"868"','"Python"',18,0,18
'"1877241"','"lovely.testlayers"','"12"',0,0,0,'"828"','"Python"',91,8,99
'"1877287"','"collective.contactauthor"','"11"',0,0,0,'"484"','"Python"',14,0,14
'"1878146"','"collective.pfg.sqladapter"','"14"',0,0,0,'"749"','"Python"',20,0,20
'"1880420"','"course-tools"','"18"',0,0,0,'"524"','"Ruby"',1,0,1
'"1880515"','"ftw.contentmenu"','"14"',3,1,4,'"827"','"Python"',136,4,140
'"1880551"','"ftw.contenttemplates"','"14"',6,1,7,'"491"','"Python"',41,4,45
'"1880579"','"ftw.dashboard.portlets.favourites"','"14"',0,0,0,'"825"','"Python"',86,7,93
'"1880642"','"ftw.bridge.proxy"','"14"',0,0,0,'"710"','"Python"',69,0,69
'"1881383"','"ftw.dictstorage"','"14"',0,0,0,'"828"','"Python"',61,1,62
'"1881396"','"ftw.globalstatusmessage"','"14"',0,0,0,'"654"','"Python"',53,4,57
'"1881412"','"ftw.publisher.core"','"14"',14,2,16,'"1081"','"Python"',188,12,200
'"1881485"','"ftw.recipe.deployment"','"14"',3,0,3,'"724"','"Python"',31,0,31
'"1882038"','"xwiki-platform-cloud"','"17"',0,0,0,'"721"','"Java"',28,0,28
'"1882217"','"zojax.gdata"','"15"',0,0,0,'"479"','"Python"',3,0,3
'"1883284"','"interview-exercises"','"12"',0,0,0,'"1116"','"Java"',59,0,59
'"1887539"','"Streams-OAuth-Libraries"','"17"',0,0,0,'"553"','"Java"',8,3,11
'"1890864"','"sensor-applets"','"10"',0,0,0,'"1270"','"Java"',101,0,101
'"1893371"','"nexus-unpack-plugin"','"30"',0,0,0,'"567"','"Java"',170,2,172
'"1893373"','"e2openplugin-MeteoViewer"','"22"',1,0,1,'"608"','"Python"',19,2,21
'"1894050"','"CatalogMetaData"','"12"',0,0,0,'"479"','"Java"',47,1,48
'"1894465"','"zodb-strip_versions"','"320"',0,0,0,'"479"','"Python"',4,0,4
'"1894566"','"cocoapods-stub"','"12"',0,0,0,'"559"','"Ruby"',5,0,5
'"1894598"','"collective.xmpp.buildout"','"320"',0,0,0,'"512"','"Python"',21,2,23
'"1895456"','"haus-start"','"13"',0,0,0,'"479"','"Python"',44,0,44
'"1899707"','"gitnesse-example-sinatra"','"24"',0,0,0,'"479"','"Ruby"',9,0,9
'"1900170"','"horizon"','"11"',0,0,0,'"500"','"Python"',14,0,14
'"1908065"','"beta2013"','"21"',0,0,0,'"514"','"Java"',15,0,15
'"1909963"','"cookbook-phantomjs"','"33"',0,0,0,'"701"','"Ruby"',14,0,14
'"1912872"','"aws-cli"','"22"',97,41,138,'"471"','"Python"',588,258,846
'"1914498"','"cucumber-tck"','"16"',1,1,2,'"1009"','"Ruby"',55,4,59
'"1916141"','"pixy-android"','"11"',0,0,0,'"478"','"Java"',8,0,8
'"1916681"','"lizard-raster"','"16"',0,0,0,'"506"','"Python"',15,0,15
'"1917781"','"redu-java-applets.heroku.com"','"14"',0,0,0,'"570"','"Ruby"',18,0,18
'"1918272"','"ftw.testing"','"14"',8,0,8,'"821"','"Python"',130,6,136
'"1918362"','"ftw.tagging"','"14"',7,1,8,'"827"','"Python"',99,3,102
'"1919260"','"django-jumpstart"','"22"',0,0,0,'"889"','"Python"',60,1,61
'"1920074"','"hwo-bot-team-103"','"25"',0,0,0,'"542"','"Python"',57,0,57
'"1920086"','"hwo-bot-team-101"','"25"',0,0,0,'"542"','"Ruby"',17,0,17
'"1920089"','"hwo-bot-team-10"','"22"',0,0,0,'"542"','"Python"',4,0,4
'"1920100"','"hwo-bot-team-11"','"23"',0,0,0,'"542"','"Ruby"',16,0,16
'"1920108"','"hwo-bot-team-109"','"23"',0,0,0,'"542"','"Java"',31,0,31
'"1920111"','"hwo-bot-team-106"','"25"',0,0,0,'"542"','"Python"',115,0,115
'"1920113"','"hwo-bot-team-117"','"24"',0,0,0,'"542"','"Python"',7,0,7
'"1920125"','"hwo-bot-team-116"','"23"',0,0,0,'"542"','"Java"',11,0,11
'"1920127"','"hwo-bot-team-115"','"24"',0,0,0,'"542"','"Ruby"',13,0,13
'"1920138"','"hwo-bot-team-123"','"25"',0,0,0,'"542"','"Ruby"',6,0,6
'"1920140"','"hwo-bot-team-125"','"24"',0,0,0,'"542"','"Python"',67,0,67
'"1920142"','"hwo-bot-team-128"','"23"',0,0,0,'"542"','"Ruby"',5,0,5
'"1920166"','"hwo-bot-team-134"','"23"',0,0,0,'"542"','"Ruby"',4,0,4
'"1920179"','"hwo-bot-team-130"','"25"',0,0,0,'"542"','"Ruby"',2,0,2
'"1920183"','"hwo-bot-team-13"','"25"',0,0,0,'"542"','"Ruby"',88,0,88
'"1920186"','"hwo-bot-team-138"','"23"',0,0,0,'"542"','"Ruby"',3,0,3
'"1920202"','"hwo-bot-team-143"','"23"',0,0,0,'"542"','"Python"',32,0,32
'"1920211"','"hwo-bot-team-139"','"23"',0,0,0,'"542"','"Python"',10,0,10
'"1920215"','"hwo-bot-team-153"','"25"',0,0,0,'"542"','"Java"',129,0,129
'"1920217"','"hwo-bot-team-147"','"24"',0,0,0,'"542"','"Python"',20,0,20
'"1920225"','"hwo-bot-team-155"','"23"',0,0,0,'"542"','"Python"',3,0,3
'"1920231"','"hwo-bot-team-154"','"24"',0,0,0,'"542"','"Python"',230,0,230
'"1920232"','"hwo-bot-team-157"','"24"',0,0,0,'"542"','"Python"',3,0,3
'"1920241"','"hwo-bot-team-158"','"24"',0,0,0,'"542"','"Ruby"',5,0,5
'"1920243"','"hwo-bot-team-159"','"23"',0,0,0,'"542"','"Python"',10,0,10
'"1920250"','"hwo-bot-team-162"','"24"',0,0,0,'"542"','"Python"',36,0,36
'"1920253"','"hwo-bot-team-16"','"25"',0,0,0,'"542"','"Java"',57,0,57
'"1920257"','"hwo-bot-team-164"','"23"',0,0,0,'"542"','"Ruby"',3,0,3
'"1920275"','"hwo-bot-team-165"','"25"',0,0,0,'"542"','"Python"',41,0,41
'"1920279"','"hwo-bot-team-169"','"23"',0,0,0,'"542"','"Ruby"',8,0,8
'"1920282"','"hwo-bot-team-168"','"23"',0,0,0,'"542"','"Ruby"',17,0,17
'"1920290"','"hwo-bot-team-177"','"25"',0,0,0,'"542"','"Python"',11,0,11
'"1920304"','"hwo-bot-team-181"','"23"',0,0,0,'"542"','"Java"',12,0,12
'"1920315"','"hwo-bot-team-185"','"23"',0,0,0,'"542"','"Python"',7,0,7
'"1920317"','"hwo-bot-team-186"','"25"',0,0,0,'"542"','"Python"',75,0,75
'"1920363"','"hwo-bot-team-190"','"24"',0,0,0,'"542"','"Python"',4,0,4
'"1920365"','"hwo-bot-team-189"','"23"',0,0,0,'"542"','"Python"',9,0,9
'"1920371"','"hwo-bot-team-193"','"23"',0,0,0,'"542"','"Ruby"',24,0,24
'"1920379"','"hwo-bot-team-197"','"24"',0,0,0,'"535"','"Python"',7,0,7
'"1920383"','"hwo-bot-team-2"','"24"',0,0,0,'"542"','"Java"',133,0,133
'"1920385"','"hwo-bot-team-20"','"25"',0,0,0,'"542"','"Python"',72,0,72
'"1920390"','"hwo-bot-team-21"','"25"',0,0,0,'"542"','"Ruby"',55,0,55
'"1920394"','"hwo-bot-team-22"','"23"',0,0,0,'"542"','"Ruby"',13,0,13
'"1920422"','"hwo-bot-team-25"','"25"',0,0,0,'"542"','"Python"',46,0,46
'"1920448"','"hwo-bot-team-30"','"23"',0,0,0,'"542"','"Python"',1,0,1
'"1920462"','"hwo-bot-team-32"','"23"',0,0,0,'"542"','"Java"',61,0,61
'"1920469"','"hwo-bot-team-36"','"25"',0,0,0,'"542"','"Ruby"',30,0,30
'"1920470"','"hwo-bot-team-37"','"23"',0,0,0,'"542"','"Python"',6,0,6
'"1920472"','"hwo-bot-team-4"','"24"',0,0,0,'"542"','"Ruby"',53,0,53
'"1920473"','"hwo-bot-team-39"','"25"',0,0,0,'"542"','"Java"',46,0,46
'"1920487"','"hwo-bot-team-43"','"25"',0,0,0,'"542"','"Java"',49,0,49
'"1920499"','"hwo-bot-team-44"','"24"',0,0,0,'"542"','"Ruby"',51,0,51
'"1920505"','"hwo-bot-team-50"','"23"',0,0,0,'"542"','"Python"',59,0,59
'"1920537"','"hwo-bot-team-62"','"25"',0,0,0,'"542"','"Ruby"',301,0,301
'"1920552"','"hwo-bot-team-64"','"23"',0,0,0,'"542"','"Ruby"',62,0,62
'"1920554"','"hwo-bot-team-73"','"24"',0,0,0,'"542"','"Ruby"',1,0,1
'"1920565"','"hwo-bot-team-70"','"23"',0,0,0,'"542"','"Ruby"',12,0,12
'"1920567"','"hwo-bot-team-76"','"25"',0,0,0,'"542"','"Ruby"',66,0,66
'"1920570"','"hwo-bot-team-78"','"23"',0,0,0,'"542"','"Ruby"',58,0,58
'"1920576"','"hwo-bot-team-77"','"24"',0,0,0,'"542"','"Ruby"',21,0,21
'"1920593"','"hwo-bot-team-85"','"24"',0,0,0,'"542"','"Ruby"',72,0,72
'"1920595"','"hwo-bot-team-83"','"23"',0,0,0,'"542"','"Java"',2,0,2
'"1920599"','"hwo-bot-team-86"','"24"',0,0,0,'"542"','"Python"',34,0,34
'"1920602"','"hwo-bot-team-88"','"25"',0,0,0,'"542"','"Python"',167,0,167
'"1920610"','"hwo-bot-team-92"','"25"',0,0,0,'"542"','"Ruby"',25,0,25
'"1920613"','"hwo-bot-team-94"','"24"',0,0,0,'"542"','"Python"',16,0,16
'"1920617"','"hwo-bot-team-93"','"24"',0,0,0,'"542"','"Python"',51,0,51
'"1920623"','"hwo-bot-team-99"','"23"',0,0,0,'"542"','"Python"',122,0,122
'"1920625"','"hwo-bot-team-98"','"23"',0,0,0,'"542"','"Ruby"',5,0,5
'"1920627"','"hwo-bot-team-97"','"24"',0,0,0,'"542"','"Ruby"',35,0,35
'"1920628"','"hwo-bot-team-96"','"24"',0,0,0,'"542"','"Ruby"',55,0,55
'"1920848"','"hwo-bot-team-187"','"24"',0,0,0,'"542"','"Java"',180,0,180
'"1922523"','"balanced-docs"','"14"',98,10,108,'"448"','"Python"',563,142,705
'"1924917"','"body_media"','"14"',0,0,0,'"483"','"Ruby"',6,0,6
'"1925729"','"CI-Comment"','"31"',0,0,0,'"492"','"Ruby"',6,0,6
'"1926419"','"broadcasters"','"14"',2,0,2,'"1081"','"Java"',32,0,32
'"1927726"','"is.idega.idegaweb.egov.course"','"10"',60,0,60,'"1688"','"Java"',386,0,386
'"1927730"','"kontrol-io-stackmob"','"20"',0,0,0,'"478"','"Java"',6,0,6
'"1927873"','"bettycrocker"','"15"',0,0,0,'"488"','"Java"',6,0,6
'"1928275"','"Robocode-Bots"','"16"',0,0,0,'"477"','"Java"',11,0,11
'"1931310"','"pentaho-commons-gwt-modules"','"49"',5,7,12,'"636"','"Java"',741,227,968
'"1933029"','"redturtle.alternative_orderui"','"11"',0,0,0,'"478"','"Python"',31,0,31
'"1937047"','"platform"','"10"',0,0,0,'"477"','"Ruby"',483,0,483
'"1937717"','"simplelayout.portlet.dropzone"','"14"',0,0,0,'"496"','"Python"',25,2,27
'"1938026"','"ckanext-iati"','"14"',13,3,16,'"842"','"Python"',582,9,591
'"1938308"','"cmsplugin-feed"','"50"',16,1,17,'"477"','"Python"',51,5,56
'"1939061"','"xwiki-clams-core"','"20"',0,0,0,'"785"','"Java"',287,0,287
'"1939073"','"examples"','"19"',0,0,0,'"542"','"Python"',5,1,6
'"1939286"','"android_packages_apps_Settings"','"16"',0,0,0,'"477"','"Java"',10,0,10
'"1939670"','"collective.vaporisation"','"11"',0,0,0,'"477"','"Python"',75,1,76
'"1940042"','"scidea-hsfc-theme"','"15"',0,0,0,'"714"','"Ruby"',16,0,16
'"1940148"','"slc.publications"','"320"',0,0,0,'"507"','"Python"',381,0,381
'"1940211"','"pminifier"','"12"',0,0,0,'"532"','"Python"',46,1,47
'"1940494"','"Products.PFGSelectionStringField"','"320"',0,0,0,'"584"','"Python"',29,0,29
'"1940820"','"automator"','"14"',0,0,0,'"800"','"Java"',102,0,102
'"1940845"','"deredactie.be.bundle"','"15"',2,0,2,'"1116"','"Python"',17,0,17
'"1941070"','"Sporza.bundle"','"15"',0,0,0,'"1110"','"Python"',13,0,13
'"1941947"','"cookbook_examples"','"24"',0,0,0,'"477"','"Ruby"',2,0,2
'"1943472"','"play-commons"','"10"',0,0,0,'"476"','"Java"',156,0,156
'"1943928"','"docbook-idea-plugin"','"58"',0,0,0,'"841"','"Java"',3,0,3
'"1944012"','"lizard-worker"','"16"',0,0,0,'"507"','"Python"',17,0,17
'"1944293"','"lizard-html2document"','"16"',0,0,0,'"505"','"Python"',6,0,6
'"1944397"','"etsproxy"','"11"',0,0,0,'"706"','"Python"',20,0,20
'"1944491"','"lizard-reportgenerator"','"16"',0,0,0,'"771"','"Python"',56,0,56
'"1944512"','"cassandralib"','"18"',0,0,0,'"491"','"Python"',47,0,47
'"1944625"','"box-connector"','"87"',12,0,12,'"735"','"Java"',149,1,150
'"1944801"','"android_frameworks_base"','"15"',0,0,0,'"477"','"Java"',53,0,53
'"1945118"','"akvo-flow-data-config"','"13"',0,0,0,'"476"','"Python"',21,0,21
'"1945456"','"jquery-plugin"','"305"',0,0,0,'"1179"','"Java"',26,0,26
'"1945508"','"projectblacklight.github.com"','"12"',1,0,1,'"1234"','"Python"',103,0,103
'"1945545"','"WebInterface"','"12"',0,0,0,'"497"','"Python"',5,0,5
'"1946092"','"SamfundetDomain"','"17"',0,0,0,'"497"','"Ruby"',27,0,27
'"1946117"','"SamfundetAuth"','"17"',2,0,2,'"491"','"Ruby"',23,0,23
'"1946145"','"vanilla"','"13"',0,0,0,'"714"','"Ruby"',45,1,46
'"1946784"','"pyiso8601"','"11"',0,0,0,'"570"','"Python"',1,0,1
'"1946978"','"glance"','"26"',1,0,1,'"617"','"Python"',2,1,3
'"1947008"','"horizon"','"26"',1,0,1,'"617"','"Ruby"',4,1,5
'"1947336"','"curly"','"17"',0,0,0,'"500"','"Java"',43,2,45
'"1947801"','"StanleyJunior"','"13"',0,0,0,'"715"','"Java"',71,0,71
'"1949337"','"ddsc-core"','"12"',0,0,0,'"475"','"Python"',207,0,207
'"1949393"','"ddsc-api"','"12"',2,0,2,'"518"','"Python"',139,0,139
'"1949450"','"youseebitrepositoryingester"','"13"',0,0,0,'"665"','"Java"',73,0,73
'"1949772"','"zojax.content.shortcut"','"15"',2,0,2,'"968"','"Python"',22,0,22
'"1951640"','"jMOM"','"12"',0,0,0,'"475"','"Java"',15,0,15
'"1951648"','"mmoInfoOxygen"','"12"',0,0,0,'"785"','"Java"',4,0,4
'"1951911"','"Concordia-Shuttle-Bus-App"','"14"',0,0,0,'"475"','"Java"',137,24,161
'"1952019"','"PerformanceTestTools"','"19"',0,0,0,'"475"','"Java"',3,0,3
'"1955134"','"oration"','"25"',0,0,0,'"476"','"Python"',26,0,26
'"1966375"','"apiomatic"','"11"',0,0,0,'"477"','"Java"',36,0,36
'"1967265"','"codemontage"','"14"',19,55,74,'"421"','"Ruby"',131,157,288
'"1971373"','"sonar-l10n-ja"','"28"',0,0,0,'"519"','"Java"',32,0,32
'"1971488"','"contest-board"','"14"',0,0,0,'"474"','"Ruby"',4,0,4
'"1977536"','"WebChallenge2012"','"14"',0,0,0,'"474"','"Ruby"',296,0,296
'"1979152"','"slave-installer-module"','"307"',4,0,4,'"482"','"Java"',20,0,20
'"1979176"','"windows-slave-installer-module"','"307"',0,0,0,'"482"','"Java"',20,0,20
'"1979261"','"upstart-slave-installer-module"','"307"',0,0,0,'"474"','"Java"',14,0,14
'"1983682"','"my315ok.products"','"320"',0,0,0,'"476"','"Python"',21,0,21
'"1984919"','"query-analyzer"','"10"',0,0,0,'"479"','"Python"',7,0,7
'"1987058"','"OverScrollView"','"10"',0,0,0,'"476"','"Java"',4,0,4
'"1987265"','"e2openplugin-CacheFlush"','"22"',0,0,0,'"502"','"Python"',9,0,9
'"1989295"','"collective.usermanual"','"320"',15,1,16,'"474"','"Python"',75,1,76
'"1989677"','"pentaho-platform"','"49"',183,163,346,'"636"','"Java"',2501,1278,3779
'"1990566"','"mongodb-buch"','"56"',0,0,0,'"484"','"Java"',27,0,27
'"1992802"','"gci"','"10"',0,0,0,'"473"','"Python"',20,0,20
'"2001477"','"bda.plone.ajax"','"320"',5,0,5,'"1147"','"Python"',45,0,45
'"2153570"','"ekbpy-contact-book"','"13"',0,0,0,'"756"','"Python"',0,0,0
'"2178983"','"konverents"','"10"',0,0,0,'"635"','"Ruby"',0,0,0
'"2264276"','"nova-network"','"16"',24,24,48,'"447"','"Ruby"',210,127,337
'"2291113"','"pentaho-reporting"','"49"',31,30,61,'"422"','"Java"',939,330,1269
'"2294498"','"pylearn2"','"12"',117,133,250,'"1200"','"Python"',751,494,1245
'"2297846"','"gusteau"','"14"',0,0,0,'"434"','"Ruby"',167,21,188
'"2311382"','"NULLwars"','"13"',0,0,0,'"411"','"Java"',31,2,33
'"2328482"','"Web1"','"10"',0,0,0,'"406"','"Java"',40,28,68
'"2343721"','"tms_client"','"16"',1,0,1,'"498"','"Ruby"',83,0,83
'"2355773"','"vault-test-tools"','"15"',8,1,9,'"453"','"Ruby"',87,6,93
'"2367064"','"asciidoctor"','"38"',101,22,123,'"643"','"Ruby"',588,400,988
'"2369446"','"MyJobs"','"14"',402,62,464,'"829"','"Python"',3024,518,3542
'"2373956"','"Intercambio-II"','"15"',0,0,0,'"404"','"Java"',381,0,381
'"2377334"','"phoenix"','"35"',84,15,99,'"413"','"Java"',1083,271,1354
'"2466155"','"releaf"','"11"',20,1,21,'"423"','"Ruby"',1219,4,1223
'"2470997"','"gittraining-sample"','"31"',0,0,0,'"396"','"Java"',26,1,27
'"2488944"','"RxJava"','"14"',181,156,337,'"422"','"Java"',822,607,1429
'"2499569"','"socode"','"15"',0,3,3,'"508"','"Python"',347,284,631
'"2559388"','"repositorioAndroid"','"10"',0,0,0,'"393"','"Java"',3,0,3
'"2562051"','"gaming"','"11"',0,0,0,'"392"','"Ruby"',13,2,15
'"2565868"','"fcrepo4"','"10"',58,43,101,'"396"','"Java"',2097,240,2337
'"2595873"','"scriptureV2"','"11"',39,0,39,'"388"','"Java"',434,0,434
'"2662982"','"matrix"','"58"',0,0,0,'"384"','"Java"',247,0,247
'"2678496"','"sample_app"','"11"',0,0,0,'"703"','"Ruby"',311,3,314
'"2714340"','"student-directory"','"11"',0,0,0,'"380"','"Ruby"',259,0,259
'"2783561"','"sq-dbsync"','"102"',0,0,0,'"376"','"Ruby"',138,10,148
'"2823798"','"DPS_Mensajes"','"31"',0,0,0,'"374"','"Java"',86,0,86
'"2826242"','"EAPLI_PL_2DC"','"22"',0,0,0,'"374"','"Java"',62,0,62
'"2892743"','"tribler"','"16"',104,90,194,'"374"','"Python"',5673,294,5967
'"2909103"','"vumi-go"','"17"',283,44,327,'"986"','"Python"',6924,712,7636
'"2932791"','"denominator"','"111"',1,1,2,'"406"','"Java"',963,181,1144
'"2943632"','"EAPLI_2013_PL_2DI"','"17"',0,0,0,'"369"','"Java"',66,0,66
'"2951736"','"railsgirls-nl"','"17"',0,0,0,'"368"','"Ruby"',85,27,112
'"3012319"','"EAPLI_PL_2DF"','"13"',0,0,0,'"371"','"Java"',29,0,29
'"3055228"','"parquet-mr"','"13"',49,23,72,'"378"','"Java"',1116,234,1350
'"3056066"','"www.ruby-lang.org"','"41"',226,90,316,'"946"','"Ruby"',1506,482,1988
'"3056652"','"www.gittip.com"','"35"',533,123,656,'"643"','"Python"',2812,492,3304
'"3074577"','"ridley"','"15"',26,14,40,'"574"','"Ruby"',535,193,728
'"3082691"','"infinispan-server"','"12"',1,1,2,'"912"','"Java"',140,204,344
'"3105682"','"c2cgeoportal"','"26"',345,57,402,'"820"','"Python"',3068,669,3737
'"3213962"','"stacktach"','"231"',36,35,71,'"547"','"Python"',252,286,538
'"3216686"','"repose"','"227"',563,65,628,'"979"','"Java"',2346,884,3230
'"3219077"','"ka-lite"','"18"',271,125,396,'"543"','"Python"',1285,685,1970
'"3263294"','"hy"','"14"',54,72,126,'"446"','"Python"',512,308,820
'"3392286"','"silverpop_client"','"37"',1,0,1,'"472"','"Ruby"',113,10,123
'"3404286"','"cfme_pages"','"17"',0,0,0,'"393"','"Python"',197,171,368
'"3411412"','"cfme_tests"','"17"',245,243,488,'"393"','"Python"',696,440,1136
'"3411703"','"sufia"','"20"',46,29,75,'"414"','"Ruby"',848,262,1110
'"3570047"','"biosys-bootcamp"','"17"',0,0,0,'"530"','"Python"',84,1,85
'"3604984"','"crichton"','"356"',155,36,191,'"393"','"Ruby"',1155,133,1288
'"3821279"','"zanata-server"','"14"',338,50,388,'"1092"','"Java"',6856,384,7240
'"3825551"','"bundler"','"25"',121,47,168,'"1500"','"Ruby"',627,703,1330
'"3929150"','"octokit.rb"','"24"',52,32,84,'"1547"','"Ruby"',430,280,710
'"3963440"','"otter"','"30"',249,56,305,'"517"','"Python"',3539,570,4109
'"4385919"','"OTM2"','"20"',128,66,194,'"380"','"Python"',835,560,1395
'"4429401"','"chillingeffects"','"14"',0,0,0,'"689"','"Ruby"',1125,210,1335
'"4571553"','"play1"','"18"',13,16,29,'"1301"','"Python"',1521,736,2257
'"4616106"','"aipo"','"25"',513,42,555,'"372"','"Java"',5212,194,5406
'"4835098"','"pombola"','"30"',529,51,580,'"976"','"Python"',2380,174,2554
